珍妮為這份禮物向我道謝|Jenny thanked me for the gift.
說話就如過眼雲煙文字卻能流傳千古|Words fly, texts remain.
你或许可以依靠他来帮助你|You may depend on him to help you.
你会弹管风琴吗?|Are you able to play organ?
我們承諾萬一他有麻煩的時候支持他|We promised to stand by him in case of trouble.
貝蒂非常愛跳舞|Betty is crazy about dancing.
她不是創辦人她是投資人|She is not the founder, she's the investor.
我没有猫|I do not have a cat.
谁帮帮她|Who helps her?
我知道你阻止不了汤姆|I know that you can't stop Tom.
汤姆说了他什么也没看到|Tom said he didn't see anything.
今年的天气不太正常|This year's weather isn't very typical.
珍看起來很快樂|Jane looks happy.
汤姆知道你在这里工作吗|Does Tom know that you work here?
請給我一張廢紙|Please get me a scrap of paper.
我剛收到一封來自巴西的信|I just got a letter from Brazil.
他们的旅行因为火车延期了|Their journey was delayed because of the train.
告訴湯姆我不會在那兒|Tell Tom that I won't be there.
她昨天得到了一個新的CD播放機|She got a new CD player yesterday.
这里不能停车|You can't park here.
倫敦不再是霧都了|London is no longer a city of fog.
她去哪買了這些東西|Where did she buy all these?
狐狸很可愛|Foxes are so cute!
這個項目要多方合作才能完成|Completing this project would require the cooperation of multiple parties.
她邊哭邊回答|She was crying as she answered.
没有人爱他|Nobody loves him.
我家就是你家|My home is your home.
這孩子哭了一整夜|The baby cried all night.
我今早給他打過電話|I called him this morning.
她向我求助|She asked for my help.
我无所谓|I don't care.
她問了一個非常好的問題|She asked a very good question.
最后一首歌是我为妻子写的一首|This last song is one I wrote for my wife.
屋子里有很多人|There are many people in the house.
那不是我的車|It's not my car.
所有的牛奶都灑出去了|All of the milk was spilled.
謝了|Thank you!
他昨天死了|He died yesterday.
他的弟弟總是在看電視|His brother is always watching TV.
你干脆也来吧|You might as well come, too.
这真的不让你感兴趣吗|Does that really not interest you?
尽管天气很冷孩子却没有大衣穿|The child had no overcoat on although it was very cold.
滾|Get the hell out of here!
护士轻柔地给我的头缠上绷带|The nurse gently put a bandage around my head.
她在等你回来|She’s waiting for you to return.
你半透明的裙子让我高度兴奋|Your see-through dress really excites me.
Jim 和 Ron 跑得一樣快|Jim runs as fast as Ron.
她驚訝得說不出話來|Her surprise was so great that she could not speak.
她取得了博士學位|She received a doctor's degree.
只會說好聽話的朋友,是你最可怕的敵人.|A flattering friend is your worst enemy.
阿尔及尔有一条美丽的海滨长廊|Algiers has a beautiful promenade on the seashore.
她們都是好學生|They are both good students.
我大概五点到这里|I arrived here about five o'clock.
我不像我以前那么拖延了|I don't procrastinate as much as I used to.
她是怎么抚养孩子的|How does she bring up her children?
两个孩子的年龄加起来和他们的父亲相当|The ages of the two children put together was equivalent to that of their father.
这是DVD|This is a DVD.
我只是照著你的指示|I just followed your instructions.
这个女士看起来很悲伤也很疲惫|The lady looked sad, also tired.
在緊急情況下打電話報警|In case of emergency, call the police.
我答應你我永遠不會離開你|I promise you I won't ever leave you.
他的大腦仍然很活躍|He still has springtime on the brain.
我們從前很窮但很快樂|We were poor, but we were happy.
那个是我爸爸|That's my dad.
在得出结论之前还是想先听听汤姆的意见|I would still like to hear Tom's opinion before coming to a conclusion.
他喜歡法語勝過德語|He likes French more than German.
我星期日並不總是有空|I am not always free on Sundays.
您走太快了|You're walking too fast.
你太过分了|You've gone too far.
當我到的時候她已經走了|She had already gone when I arrived.
人是一種動物|A human is an animal.
我住在伊斯坦布爾的安納托利亞一側|I live in the Anatolian side of Istanbul.
米迦勒是男人的名字但蜜雪兒是女人的名字|"Michael" is a man's name but "Michelle" is a lady's name.
你要做什么|What are you going to do?
她总是很自卑|She is always so unconfident.
你是说我的情绪问题跟那些白痴没什么两样吗|Are you trying to suggest that my emotional problems are no different than those of a stupid person?
他打了墙壁一拳|He hit the wall with his fist.
您听到什么了|What did you hear?
他很少如果有的話去教堂|He seldom, if ever, goes to church.
看她來了|There! She comes!
你才對|You're correct.
放弃这个想法吧|Give up such ideas.
谢谢你|I thank you.
试衣室正在占用着|The fitting room is occupied.
汤姆在我走后到了|Tom arrived after I left.
这事是什么时候发生的|When did this occur?
她开了窗尽管我叫她别这么做|She opened the window, even though I told her not to.
因为她生病了所以她没去学校|She got sick, so she didn't go to school.
我在找我的隱形眼鏡|I'm looking for my contact lens.
禁止入池|Entry of pool is prohibited.
他的脸失去了所有颜色|His face turned pale.
他是我最好的女性朋友|She is his best girlfriend.
我姓凌|My surname is Ling.
我一整周都不能去学校了|I couldn't go to school for a whole week.
讓我介紹我父母給你認識|Let me introduce my parents to you.
麥根沙士被視為一種經典的美式碳酸飲品|Root beer is considered a classic American carbonated soft drink.
她让我幸福|She makes me happy.
可不容易|It hasn't been easy.
我的妻子是乌鲁木齐人|My wife is a native of Ürümqi.
我去過京都三次|I have visited Kyoto three times.
汤姆恐高|Tom is afraid of heights.
她的帽子被风吹掉了|She had her hat blown off by the wind.
我欠她10美元|I owe ten dollars to her.
她对他们很严酷|She is hard on them.
有成千的人来参加今天的集会|There are thousands of participants at today's event.
我背不好|I have back problems.
原来你是这样想的|Ah, so that is your thinking!
玻璃易碎|Glass breaks easily.
你來自北海道不是嗎|You are from Hokkaido, aren't you?
我打算每天花幾個小時來學英文|I intend to devote a few hours a day to the study of English.
我們住在學校附近|We live close to the school.
我還要贏得更多|I still need to win more.
我饱得动不了|I'm too full to move.
懦夫難贏美女心|Faint heart never won fair lady.
我把鞋脫了然後將它們放在床下|I took my shoes off and put them under the bed.
他停下来抽根烟|He paused to have a cigarette.
这种钱包你卖吗|Do you sell this type of wallets?
我越了解人我就越喜歡動物|The more I know about people, the more I like animals.
戒烟难|It's difficult to quit smoking.
美國警察穿藍色的制服|The American police are in blue uniforms.
不收小費|No gratuity accepted.
牙齿卡了点东西|You've got something stuck in your teeth.
你很快就会习惯吃日本料理了|You will soon get used to Japanese food.
Linux系统的高手都会用命令行|Linux experts are able to use the command line.
冬天结束了|Winter is over.
湯姆講法語好像比以前好|Tom seems to speak French better than before.
他是个日本少年|He's a Japanese boy.
昨天突然傳出了兩間公司合併的消息|The news of the merger of the two companies broke yesterday.
我不太相信將來的一天世界上大多數人都會講世界語|I don't believe that some day a majority of the world's population will speak Esperanto.
没事|No worries.
我没想到你们希望自己做|I didn't think that you'd want to do that by yourselves.
看来他会在下个月来|It looks like he'll be coming here next month.
誰要死了|Who's dying?
南極因為有大陸所以氣溫低於北極|Owing to its landmass, the Antarctic has an air temperature lower than that of the Arctic.
聽起來很有趣|That sounds very interesting.
巴西向世界各地供應優質咖啡豆|Brazil supplies the world with coffee beans of quality.
汤姆看起来不饿|Tom didn't seem hungry.
你們會說英語嗎|Can you speak English?
这条路连接东京和大阪|This road connects Tokyo with Osaka.
你已经到家了吗|Are you already home?
這附近有一個軍事基地|There is a military base near here.
湯姆會殺瑪麗|Tom is going to kill Mary.
她把這個工作派給他做|She assigned the work to him.
好簡單的問題啊|What an easy problem it is!
讓我介紹我父母給你認識|Let me introduce you to my parents.
你看他傻乎乎的模样倒也挺可爱|Look at him. He looks like an idiot but he's also very cute.
我羡慕他|I envy him.
这个饮料的味道很明显是茶的味道|This drink's flavor is obviously that of tea.
我妈妈的爸爸是我的外公|My mother's father is my maternal grandfather.
我的腳起水泡了|I've got blisters on my feet.
问他会不会来参加会议|Ask him if he will attend the meeting.
她懷孕後仍然堅持工作|She still went to work even after getting pregnant.
在未來赤道附近的居民很有可能成為氣候難民|In the future, people who live in equatorial regions will probably be climate refugees.
她買了一些布料打算為自己做一條裙子|She has bought some cloth; she is going to make herself a dress.
别说谎!|Don't tell lies.
他很勇敢|He is very brave.
这是你的信|Here is a letter for you.
这个学期我们有两次考试|We have two examinations during this term.
我們只是需要確認Tom有要來這|We just have to make sure Tom is planning to be here.
肯定有人看見了發生了什麼|Somebody must have seen what happened.
我在星期日不工作|Sunday is not a workday for me.
是的你需要每天练习|Yes, you need to practice every day.
生日快樂Shishir|Happy birthday, Shishir!
去吃饭吧|Let's go to eat.
儘管她想過一個人去國外旅行她改變了主意|Though she wished to travel abroad by herself, she thought better of it.
一會兒見|See you soon!
汤姆三年前从高中学校毕业了|Tom graduated from high school three years ago.
他不需要女朋友|He doesn't need a girlfriend.
叫救护车|Call an ambulance.
你吃了什么|What did you eat?
我什么都不怕|I'm not afraid of anything.
这不关你的事|It's none of your concern.
你想吃點東西嗎|Do you want to eat anything?
当心坠落|Watch out for the drop.
他的問題最終沒被回答|His question remained unanswered.
我不喜欢跟人打交道|I don't like to socialize.
他們已經到處找過他可是卻哪裏也找不到他|They looked everywhere for him, but couldn't find him anywhere.
她埋葬了她的独生子|She has buried her only son.
令我非常伤心的是她考砸了|She failed the examination and I was greatly disappointed.
我们穷但是很快乐|We are poor, but we are happy.
我想让你穿这件|I want you to wear this.
他說很可能會下雨|He observed that we should probably have rain.
你能让我知道汤姆什么时候来吗|Would you let me know when Tom comes?
我掀開了蓋子|I opened the lid.
每一個生肖的背後都有著數不盡的成語諺語和故事|Behind every animal on the Chinese zodiac lies an array of proverbs, sayings and stories.
我們認為他們不會買新車|We do not anticipate their buying a new car.
他保证过会来却没有来|He promised to come, but he didn't come.
她全身都疼|She was aching all over.
湯姆是對數學感興趣|Tom is interested in mathematics.
是不是嚇人|Scary, isn't it?
那是最近發生的嗎|Did that happen recently?
你身上有很多钱吗|Do you have a lot of money on you?
汤姆吃了纯素食千层面|Tom ate vegan lasagna.
你在不在市區|Are you in the city or not?
你不用著急|You don't need to hurry.
过河拆桥|Burn that bridge when one comes to it.
下禮拜我要去拜訪她一下|I'm going to visit him next week.
請把帳單給我好嗎|May I have the check, please?
我們覺得她一個人去很危險|We thought it dangerous for her to go alone.
她情緒低落|She felt blue.
我從沒在晚上釣過魚|I've never gone fishing at night.
如果我錯了請你指正|Correct me if I'm wrong.
你要是願意就留在這裡|You can stay here if you like.
我想要你的一张照片|I want your photograph.
比爾拿了一杯水給我|Bill brought me a glass of water.
我要控告你|I will sue you.
你的媽媽是西班牙人嗎|Is your mom Spanish?
我意识到虽然中国发展得很快中国人还有比较悠闲的生活|I have come to realize that China is developing quickly but the Chinese people live a relatively leisurely life.
我想知道他们在哪|I want to know where they are.
鈴響後他就到了|He arrived after the bell rang.
為健康戒了煙|I gave up smoking for the sake of my health.
我被熨斗燙傷了|I was burnt by the iron.
他们的友情酝酿成爱情的果实|Their friendship ripened into a deep love.
她不会乘飞机因为害怕坠机|She won't take an airplane for fear of a crash.
他活到了70歲|He lived to be seventy years old.
不少人認為所有外國製造的物品均優於那些在本國所製造的|Not a few people think that all foreign-made articles are superior to ones made in this country.
邁克歌唱得很好|Mike sings well.
他在自己三十岁生日那天自杀了|He killed himself on his thirtieth birthday.
她又在说这说那|She's complaining about this and that, again.
我可以和你一起呆在这里吗|Can I stay here with you?
春天快來了|Spring will come soon.
他是个钢琴家|He's a pianist.
他在這個鎮上經營一家超級市場|He runs a supermarket in the town.
你知道它爲什麼會發生嗎|Do you know why it's happening?
德国人诡计多端|The Germans are very crafty.
訪客坐在我的對面|The visitor sat across from me.
我三十歲|I'm thirty.
可惜汤姆不能来|It's too bad that Tom couldn't come.
今天我是开车上班的|Today I came to work by car.
微风吹荡着湖面|A light breeze stirred the surface of the lake.
來玩捉迷藏吧|Let's play hide-and-seek!
就我而言我很满意|As for me, I am satisfied.
我們需要英雄|We need a hero.
我的夢想是成為一名棒球運動員|My dream is to be a baseball player.
她的话很多|She talks a lot.
这把塑料椅子很便宜|This plastic chair is very cheap.
我没买面包|I didn't buy bread.
一碗飯大約重一百八十克|A bowl of rice weighs about 180 grams.
我们应该禁止针对儿童的广告|We should ban advertising aimed towards children.
我在晚上工作|I work nights.
你的中文已经登峰造极了|Your Chinese is awesome already.
您说的话完全跑题了|What you say is quite wide of the mark.
汤姆说它十分重要|Tom says it's quite important.
哦我很遺憾聽到這個消息|Oh! I'm sorry to hear that.
这个网站看起来不错|This website seems quite good.
他远远地看着|He watched from a distance.
我会打电话给你|I'll give you a ring.
說句簡單的話|Say a simple phrase.
我可以自我介紹嗎?|May I introduce myself?
我以前从未见过这样的事情|I've never seen anything like this before.
如果我忘記了請提醒我|In case I forget, please remind me.
我睡午觉的时候做了个怪梦|While napping, I had a strange dream.
沒有車她做不了事|She cannot do without her car.
幸運的是我們找到了逃生通道|Luckily, we found an escape route.
他又弄丟了雨傘|He lost his umbrella again.
我常常访问我的亲戚|I often visit my relatives.
总之下一步是要决定我们下一步应该做什么|In conclusion, the next step is to decide what we should do for the next step.
我们知道|We know.
天氣好冷|It's freezing.
她会说英语和德语|She can speak both English and German.
我等了不止三小時|I waited more than three hours.
我什么都看不见|I didn't see anything at all.
如果你喜歡你可以用我的車|You can use my car if you like.
我已经尽力了|I've done my best.
下雨了但是我依然需要出去|Although it was raining, I had to go out.
湯姆把我給完全忘了|Tom forgot all about me.
你最好請教你的醫生|You'd better consult your doctor.
她胆小|She's cowardly.
您往裡放了什麼|What have you put in there?
警察命令他们停手|The policeman commanded them to stop.
他把诗翻译成英语|He translated the verse into English.
一年之中你最喜欢哪个季节|What's your favorite season of the year?
你不再能伤害到我了|You can no longer hurt me.
每个人都知道汤姆的法语很好|Everyone knows that Tom speaks good French.
我看到湯姆做什麼了|I saw what Tom did.
湯姆說我絕不該做|Tom told me I shouldn't ever do that.
金窝银窝不如自己的狗窝|Be it ever so humble, there's no place like home.
他们说这属于他们|They said it belonged to them.
他馬上戴上了他的帽子|He put on his hat at once.
他娶了一個漂亮的女孩|He married a pretty girl.
我和他们意见一致|I think the same as they do.
我觉得太遗憾了|I feel extremely regretful.
你有18歲了嗎|Are you over 18?
加胡椒|Add pepper!
你最害怕的是什么|What is your biggest fear?
湯姆年紀比我大|Tom is older than I.
我們往下看是一片水泥叢林|Looking down, we saw a concrete jungle.
尽管语言和习俗不同大家还是能够成为朋友|Despite different languages and cultures, everyone still became friends.
但是他很想生個兒子|But he wanted a son very much.
我的書在哪裏|Where is my book?
汤姆在海边发现了具尸体|Tom found a dead body on the beach.
他们俩都不喜欢我|They both don't like me.
我每天都帮我妈做家务|I help my mother with the housework every day.
我不是醉了只是睏了|I'm not drunk, I'm just tired.
我見到一片白雲在空中飄過|I saw a white cloud sailing across the sky.
这很可能意味着战争|In all likelihood, this means war.
日本政府无法管理问题|The Japanese government can't cope with the problem.
我和你保证|I gave you my word.
大卫在家里|David is at home.
这张票三日有效|This ticket is good for three days.
你可以看這書|You can read this book.
您需要重新启动电脑|You need to reboot your computer.
鱼与熊掌不可兼得|You cannot eat your cake and keep it.
我们待在舅舅家|We're staying at our uncle's.
那改变了一切|That changed everything.
他對他的妻子不忠|He's cheating on his wife.
过马路时小心.|Take care when you cross the street.
湯姆甚麼也沒給我看|Tom didn't show me anything.
你在那里做什么呢|What're you doing there?
你應該幫助他|You should help him.
我天黑之前到达了村庄|I arrived at the village before dark.
我回家换了衣服|I went home to change clothes.
這本是我讀過最好的書|This is the best book I have ever read.
這匹馬停下來不動了|The horse stopped and wouldn't move.
飞机场在那边|The airport is over there.
现在正缺良好的建筑木材|There is a shortage of good building wood.
瑪莉不知道該和他說甚麼才好|Mary is at a loss what to say to him.
我會在這裡等直到他來|I will wait here till he comes.
讀完他的書後我覺得我可以構建一棟房子|After reading his books I feel I can construct a house.
我們乘著獨木舟向河的下游而行|We went down a river by canoe.
他和 Ann 結了婚|He married Ann.
正有什么奇怪的事情发生着|There's something odd going on.
80％的英語單字來自其他語言|80% of all English words come from other languages.
我們為她舉辦了一個歡迎會|We had a welcome party for her.
我有点紧张|I was a little bit nervous.
这辆车停在银行前|The car pulled up in front of the bank.
這就是他用來簽署那份文件的筆了|This is the pen that he signed the document with.
什么都改变了|Everything's changed.
這則訊息將在五秒後自動銷毀|This message will self-destruct in five seconds.
我今天很饿了|I'm very hungry today.
我哭了整个晚上|I cried all night.
我無法理解她所說的|I could not catch her words.
我讨厌在情人节一人独处|I hate being alone on Valentine's Day.
汤姆坐在玛丽旁边|Tom sat beside Mary.
他们谈计划谈了几个小时|They talked over the plan for hours.
无解|There isn't any solution.
我讓她興奮|I excited her.
父母很重视孩子的教育|The parents value their children's education.
他对我的话充耳不闻|He turns a deaf ear to me.
我知道要相信这件事很难|I know it's hard to believe.
如果你高興我就高興|If you're happy, I'm happy.
他們目光相接|Their eyes met.
他现在出去了|He has left now.
他的瘫痪正在恶化不久他就不能下床了|His paralysis is progressing, and soon he won't be able to get out of bed.
我每次看这部电影都会哭|I cry every time I watch this movie.
我很累, 然而, 我必須完成我的回家作業|I am tired; nevertheless, I must finish my homework.
他反对妻子在外工作|He objected to his wife working outside.
我很好|I'm fine.
你也許不同意他們某些重大政策這可能會影響你的工作關係|You may not agree with some of their major policies and this could affect your working relationship.
我上中學的時候有寫日記的習慣|I used to keep a diary when I was at high school.
著名的鐵琴演奏家Stefon Harris已經錄製了至少一個巴拉風獨奏|Famous vibraphonist Stefon Harris has recorded at least one balafon solo.
请给我些时间来解释|Please give me a minute to explain.
我去车站为我朋友送行|I went to the station to see my friend off.
聽他的談吐就知道他不是美國人了|I know from his speech that he is not an American.
是的狄馬一邊回答一邊把黏在他右邊衣袖的一塊吃剩的魚肉撥走我想要那邊的那一件|"Yes," Dima replied, brushing off a piece of half-eaten fish that had gotten stuck to his right sleeve. "I'd like to buy that one there."
這隻老鼠跑進洞裡|The mouse ran into the hole.
作为一个孩子你的表现还说得过去|Your actions are tolerable, as a kid.
Igor 酒還沒醒|Igor was still drunk.
狗對著郵差叫|The dog barked at the mailman.
這句句子的文法是對的|This is a grammatically correct sentence.
昨晚我做了一个可怕的噩梦|I had a really bad nightmare last night.
警察逮捕了謀殺這位小姐的兇手|The police arrested the man who had murdered the girl.
小洞及時補免遭大洞苦|A stitch in time saves nine.
我需要預約位子嗎?|Do I need a reservation?
他后来写信给总统|Later he wrote to the president.
天空晴朗布满了星辰|The sky is clear and full of stars.
真的|Seriously?
你被车撞过吗?|Have you ever been hit by a car?
這種癥狀在我身上將會持續多久|For how long will I continue to have these symptoms?
我让一个有着奇怪玻璃眼珠的老太太帮我算了命|I had my fortune read by an old lady with an eery-looking glass eye.
他已经意识到它了|He already knew about it.
我們需要多少糖|How much sugar do we need?
除了雨天我每天都散步|I take a walk every day except when it rains.
我尽量不去想它|I just try not to think about it.
我不想买这样的沙发|I don't want to buy this kind of sofa.
我要跟你分手了|I want to break up with you.
我什么都看不见|I can't see a thing.
為了觀測星象他建了一座瞭望台|He built an observatory to study the stars.
你对她是不是一见钟情|Did you fall in love with her at first sight?
請給我一杯水|Please give me a glass of water.
我不認為他會來|I don't think he will come.
很冷|It's so cold.
這位老人餓死了|The old man starved to death.
鎮上的每個人都知道它|Everyone in the town knows about it.
我希望他能來我想見他|I hope he'll be able to come! I'd like to see him.
Aoi在跳舞|Aoi dances.
你为什么醒着|Why are you awake?
汤姆及时赶到了车站搭上了他想搭的那列车|Tom got to the station in time to catch the train he wanted to catch.
我给你吃手馒头|I'll give you a mantou to eat.
他在学习德语|He's learning German.
我没有四个兄弟|I don't have four brothers.
我的襪子已經乾了嗎|Are my socks dry already?
他在哪家公司工作|Which company does he work in?
你们有什么不吃的吗|Is there something you don't eat?
你剛剛才吃過晚飯不可能餓得這麼快的|You can't be hungry. You've just had dinner.
湯姆點了雪茄|Tom lit his cigar.
你這個週末要做什麼|What're you going to do this weekend?
做該做的事是智慧做不該做的事是愚癡|Intelligence is doing what you are supposed to, while stupidity is doing what you are not supposed to.
去公园散步你觉得怎么样|What do you say to taking a walk in the park?
物价上涨是多方因素造成的|Several factors operated to help prices go up.
他造了一個機器人|He made a robot.
你必须忍受这一切的噪音了|You have to put up with all this noise.
她的笔迹漂亮极了|She writes an excellent hand.
你最后一次看到汤姆是什么时候|When did you last see Tom?
他的公司沒有從危機中倖存|His company didn't survive the crisis.
你想用這支筆我就借給你吧|If you want this pen, I'll lend it to you.
我很想知道她的名字|I really want to know her name.
由于最初设计中的一个缺陷我们的网站易受到SQL注入攻击|Because of a flaw in the original design, our website is vulnerable to SQL injection attacks.
你比你想得好|You're better than you think.
每个人都需要做了这个|Everybody had to do this.
谈严肃的事时要严肃|One must speak about serious things seriously.
我希望只有这一个|I hope it will be the only one.
他的头撞倒了一块岩石|He hit his head against a rock.
Ken昨天在家吗|Was Ken at home yesterday?
从2008年到2011年我在美国生活|I lived in the US from 2008 till 2011.
如果你弄乱了你来打扫|If you make a mess, clean it up.
你去看醫生以前已經病了多久了呀|How long had you been sick before you saw the doctor?
地球只不過是懸浮在太空中的一個球體|The earth is just a sphere suspended in space.
祝你夢想成真|I hope your wishes will come true.
必须的|Definitely!
汤姆把他的法文课本弄丢了|Tom lost his French textbook.
您什么时候方便|When would it be convenient for you?
“明”這個漢字左邊是什麼右邊是什麼|In "明", what is the character on the left? And the one on the right?
昨晚你累了嗎|Were you tired last night?
你不應該離開這個房間|You're not to leave this room.
最后一个听我说我的主意的人认为我疯了|The last person I told my idea to thought I was nuts.
農業需要消耗大量的水|Agriculture consumes a great amount of water.
我等着出租车|I was waiting for a taxi.
湯姆看來感冒了|Tom seems to have a cold.
我真的認爲我們該做|I really think we should do this.
统治一个国家不是一件简单的工作|To rule a country is no easy task.
告诉我正确的答案|Tell me the correct answer.
我懒得整理我的头发所以我看起来就像个懒汉|I'm lazy about my hair, so I tend to look like a slob.
为了不被洪水冲走有的人紧紧地抱着树干长达数个钟头|Some people clung to tree branches for several hours to avoid being washed away by the floodwaters.
不止你 连我也被牵连了|Not only you but also I was involved.
我踢足球|I play soccer.
一片一片的白雲在上空飄過|Clouds sail across the sky.
請你把收音機關掉|Turn off the radio, please.
你留着它好了|I think you can keep it.
汤姆很自恋|Tom is a narcissist.
明天下午之前我会把它完成|I will finish it by tomorrow afternoon.
你好像很忙|You seem busy.
你这孩子别老是接触一些陌生人很危险的|Son, stop always getting so close to strangers. It's very dangerous!
汤姆要来了|Tom is coming.
别碰我|Don't touch me.
只有个别人才懂了我的意思|Only a few people understood me.
世界上任何山峰都达不到珠穆朗瑪峰的高度|No other mountain in the world is so high as Mt. Everest.
秋天到了樹葉也開始落下|Autumn came and the leaves started to fall.
您生气了吗|Are you angry?
请替我向你父亲问好|Please give my regards to your father.
我一直在找你|I've been looking for you.
她告訴我把窗戶打開|She told me to open the window.
我把这封信寄给爷爷了|I sent this letter to my grandfather.
汤姆醉了|Tom's drunk.
那看起來好危險|That looks really dangerous.
这是可疑的|This sounds fishy.
Meier先生以为Neumann一家去度假了|Mr. Meier thought the Neumann family was away on vacation.
冬天已经过去了|Winter is gone.
我劝他别老想着啃老|I advised him to be independent of his parents.
我喜欢你的车|I like your car.
我是从罗马来的|I'm from Rome.
雖然我只是在網上看了幾則新聞但也大概知道了整件事的來龍去脈|I'm only reading the scraps on news on the Internet, but, well, I get the general picture.
明年预算的计算是基于今年的成本的|The calculation of the budget for next year is based on the costs this year.
他們通常在這個房間裡睡覺|They usually sleep in this room.
我三月二十二号生日|My birthday is on March 22.
不要唬我了|Don't give me that crap!
你看太美啦|Look, it's so pretty!
她是我的上司也同時是我最要好的朋友|She is my boss and also my best friend.
我的牙很痛|My tooth hurts.
冷静下来|Get a grip on yourself!
黑的电话比白的花钱多|The black telephone costs more than the white.
有人被謀殺了|Somebody was murdered.
她什么都不知道|She knows nothing.
我來感謝你|I came here to thank you.
自从他离开去法国已经有两个月了|Two months have passed since he left for France.
我觉得这值得一问|I think it's worth asking.
但願我有一輛車|I wish I had a car.
汤姆是一个有趣的人|Tom is an interesting man.
汤姆认为那是个玩笑但是没人笑|Tom meant it as a joke, but nobody laughed.
我听说你们结婚了|I heard you got married.
我不喜歡咖啡|I don't like coffee.
这没有任何区别|That won't make any difference.
五加三等於八|Five plus three equals eight.
他七年前來日本|He came to Japan seven years ago.
第一步是最麻煩的|It is the first step which is troublesome.
我討厭英語和一切和英語有關的東西|I hate the English language and everything related to it.
那個男人抓住了這個年輕女孩的手腕|That man grabbed the young girl's wrist.
我不知道湯姆說没說實情|I don't know if Tom told the truth or not.
汤姆认为是酷儿|Tom identifies as queer.
我正在大学里读经济|I'm studying economics in college.
我們討論那個問題討論了很久|We discussed the problem for a long time.
您该为您的粗鲁道歉|You should apologize for your rudeness.
我若拜访你会让你提前知道的|When I call on you, I'll let you know in advance.
我來了|I came.
他喜歡看電視|He likes watching TV.
大家都喜欢她|Everyone likes her.
看书很有意思|Reading a book is interesting.
高卡路里的食物對我的身體不好|High calorie foods are bad for my health.
在思想的領域中, 荒誕和墮落仍然主宰著世界, 它們的操控只是短時間地被暫停|In the sphere of thought, absurdity and perversity remain the masters of the world, and their dominion is suspended only for brief periods.
無論發生甚麼事你也要保持鎮定|Stay calm whatever happens.
我的哥哥比我大两岁但他却比我矮三厘米|My brother is two years older than me, but three centimeters shorter.
这本书小|This book is small.
我爸快四十了|My father will be forty soon.
我們現在去哪裡去劇場還是電影院|Where shall we go now? To the theatre or cinema?
他还在这儿|He is still here.
汤姆和我是老朋友|Tom and I are long-time friends.
在打网球方面他和我势均力敌|He is a good match for me in tennis.
外面在下雪|It was snowing outside.
你为什么要唤我起来告诉我如此晴天霹雳的消息? 现在你教我如何认真工作?|Why did you wake me up to tell me something that big? Now, I'll never be able to concentrate on my work!
今年雪比去年下得多|This year we had more snow than last year.
愿有情人终成眷属|May those who love each other end up together.
他悲伤的故事触动了我的心|His sad story touched my heart.
我不確定但我覺得我知道要去哪裡|I'm not sure, but I think I know where to go.
你有幾個小孩?|How many children do you have?
往返各地的收费如下|Round-trip fares to each destination are as follows.
老实说我们是来抓你的|To be honest, we came to capture you.
汤姆脑瓜灵|Tom has a good head on his shoulders.
我不喜欢那些数学家知道的比我多得多却不知道清楚地表达自己|I don't like it when mathematicians who know much more than I do can't express themselves explicitly.
那個箱子太小了裝不下這麼多的東西|That box is too small to hold all these things.
大部分客人是外国人|The greater part of the guests were foreigners.
明天会下雨吗|Will it rain tomorrow?
她劝我别相信她的话|He advised me not to believe what she says.
你愛上我了|Are you in love with me?
我也过得很愉快|I also had a very good time.
我和瑪莉成了好朋友|Mary and I became good friends.
那是一个安静的夜晚|It was a quiet night.
汤姆是班里唯一的男生|Tom was the only boy in the class.
他提出了幾個改變事物的方法|He gave several examples of how we could change things.
德伦特方言是低地撒克逊地区的一个方言群|Drents is a group of variants of the Low Saxon regional language.
我喝了兩杯咖啡|I had two cups of coffee.
你有字典嗎|Do you have a dictionary?
那是另一回事|That is another matter.
那是座老城堡|That is an old castle.
虽然我们大多数人比我们的父母祖父母还要富裕得多但是与之相应的快乐程度却没有多大的改变|While most of us are significantly better off financially than our parents and grandparents, happiness levels haven't changed to reflect that.
学好一门外语需要坚韧不拔的毅力|Mastering a foreign language involves a lot of patience.
他们一边唱歌一边走路|They went along the street singing the song.
你觉得这本书的哪个译本比较好法语的还是英语的|Which translation of this book do you think is better? The French one or the English one?
我有三只狗其中一只是公的另外两只是母的|I have three dogs. One is male and the other two are female.
一朵白云在蓝天上飘|A white cloud is floating in the blue sky.
他们为祖国而战斗|They fight for their country.
她建议我取消会议|She suggested to me that I call off the meeting.
我把正门漆成蓝色了|I painted the gate blue.
“谢谢你们” “不用谢”|"Thanks, guys." "Don't mention it."
我每天都去森林散步|I walk in the forest every day.
暑假期间我在邮局工作|I worked in a post office during the summer vacation.
你的行為引起了許多的麻煩|Your behavior is creating a lot of problems.
我不是想要羞辱你|I didn't want to humiliate you.
告示牌上寫著出口|The sign says "Exit."
他永遠地離開非洲了|He left Africa forever.
她一定是生病了|She must have been sick.
我饿了|I am hungry.
您想吃点什么吗|Would you like to eat something?
圣诞快到了|Christmas is drawing near.
我在打棒球|I'm playing baseball.
我得了金牌|I won the gold medal.
我信过你|I believed you.
我有跟你同樣的麻煩|I have the same trouble as you have.
我差點被車撞倒|I was nearly hit by a car.
這台機器很容易操作|This machine is easy to handle.
哎呀我不知道啦|Oh, I don't know.
我把我的新鋼筆搞丟了|I've lost my new fountain pen.
你认识钱先生吗|Do you know Mr Qian?
我不想喝太多的咖啡|I don't want to drink too much coffee.
她讓他去洗手|She told him to wash his hands.
告诉我他怎么弄到的|Tell me how he got it.
款式很不錯不過有沒有別的顏色|The style is nice, but do you have it in a different color?
第一个被我抓到在玩游戏在QQ上聊天在开心网上看文章的人请出去这是教室不是网吧|The first person that I see playing a video game, chatting on QQ, or reading articles on Kaixin, is going to be shown the door. This is a classroom, not a cybercafé.
你的兄弟多高?|How tall is your brother?
我不知道我能不能再做一次|I wonder if I can do it again.
自由是我们所力争的|Freedom is what we're fighting for.
把你的絲襪拉上去|Pull up your stockings.
这把刀的刀锋很利|The knife has a keen blade.
雖然下着大雪但他還是來了|He came in spite of the heavy snow.
今天强盗大白天的就抢了另一家银行|The thieves knocked off another bank today in a daytime robbery.
他时不时地因为工作去东京|From time to time, he goes to Tokyo on business.
我是一個外國人|I'm a foreigner.
你想我们先结婚还是先生孩子|Do you want to get married first or have a child first?
请为Image Viewer的界面选择语言|Please select a language for the Image Viewer interface.
那商店里的商品全都打九折呢|Everything at that store is 10 percent off the regular price.
用你的橡皮擦把這些字擦掉|Rub out these words with your eraser.
银行在哪里|Where is the bank?
我很高興能夠認識您|I'm glad to make your acquaintance.
她希望成為一名設計師|She wants to be a designer.
请确认|Please confirm.
請說大聲一點兒|Please speak more loudly.
瑪麗比我好看|Mary is prettier than me.
我想要本书书店在什么地方|I want a book. Where is the bookstore?
事情是怎麼到這個境地的|How did things get this far?
她的房子在河的另一边|Her house is across the river.
我不習慣在公眾場合說話|I'm not used to speaking in public.
我已经好久没有看到她了|I haven't seen her for a long time.
我想让你知道你对我有多重要|I want to let you know how important you are to me.
你要看一部法国片是吗|You want to watch a French film, is that right?
就是没有人陪我我也要去看这部电影|Even if no one goes with me, I still want to see this movie.
在我的部门里有七男四女|There are seven men and four women in my section.
把米饭和鸡蛋及酱油混一下|Mix the rice, egg and soy sauce.
走開別在這兒玩兒|Get out! Don't play here!
听到这个悲伤的消息她泣不成声|Hearing the sad news, she collapsed in tears.
我冒著生命危險找到了這個|I found this at the risk of my life.
你怎麼在桌子底下|Why are you under the desk?
湯姆還沒做完|Tom wasn't finished yet.
一个丑男人敲了我的门|An ugly man knocked on my door.
我不知道穿甚麼好|I have no idea what I'm going to wear.
我不能叫他做那件事|I can't ask him to do that.
抓贼啊|Grab the thief!
你覺得留那種言很好笑嗎?|Do you think leaving this kind of message is funny?
我没有准备好|I'm not prepared.
所有人都注意到了|Everyone noticed that.
他把他的生命给了国家|He gave his life for the nation.
天空很晴朗|The skies are clear.
事实上他并不是主管|He is actually not the manager.
再来一步你就死了|One more step, and you're dead.
汤姆正要为我们铲掉屋顶上的雪|Tom is going to shovel the snow off the roof for us.
她每週日早上很晚起床|She gets up late on Sunday mornings.
我相當肯定湯姆的成功|I'm quite sure of Tom's success.
Tatoeba是什麼意思|What does TATOEBA mean?
我们相信民主|We believe in democracy.
我有时早上不想下床|I sometimes just don't want to get out of bed in the morning.
汤姆想让玛丽更努力地学习|Tom wants Mary to study harder.
你和我在这里很安全|You're safe here with me.
您很快就会知道世界语了|You will know Esperanto very soon.
我们的猫很胖|Our cat is fat.
我跑|I run.
我想办法克服了对别人吹毛求疵的毛病|I've found a way to overcome my habit of always picking fault with others.
老人在骡子的背上放上了一个个装满了沙的袋子|The old man loaded his mule with bags full of sand.
汤姆能游得很好|Tom can swim pretty well.
你收到我寄給你的包裹了嗎|Did you get the parcel I sent you?
这就是抉择所在|This is the dilemma.
我不认识任何一个盲人|I don't know any blind men.
他很快就适应了新的环境|He soon got used to the new surroundings.
我們坐地鐵去吧|Let's go by metro.
我必须睡了|I have to go to sleep.
入乡随俗|Do in Rome as the Romans do.
責任應該由你來負|It is you that are to blame for it.
我想要的就是这个|This is just what I wanted.
关门|Close the door.
我认为不是汤姆做的|I think Tom didn't do that.
鬱金香很快將盛開|Tulips will bloom soon.
你有湯盤嗎|Do you have a soup dish?
你不必打电话给我|You don't need to give me a call.
你週日不上學, 對嗎?|You don't go to school on Sunday, do you?
無論你多麼努力也不可能只花一年左右就精通英文|However hard you may study, you can't master English in a year or so.
我知道你会生气|I knew you'd be furious.
我可以和你跳一支舞嗎|Can I have a dance with you?
对工具箱里只有一把榔头的人来说所有的问题都像钉子|To the man who only has a hammer in the toolkit, every problem looks like a nail.
Tatoeba不是词典|Tatoeba is not a dictionary.
那不完全是錯的|That is not entirely wrong.
我爱我的祖国|I love the fatherland.
生活从不会停止但世俗生活却会|Life never ends but earthly life does.
我会做任何事|I'll do anything.
我已經好久沒有見到你了|I haven't seen you in ages.
這是一件十分耗時的工作|This is a very time-consuming task.
我是林|I am Lin.
觀眾似乎覺得無聊|The audience seems to feel bored.
你會在日本多久?|How long are you going to stay in Japan?
这场事故发生在我们的眼皮子底下|The accident happened right before our eyes.
我灵感枯竭了|My inspiration has run dry.
我准时赶上了火车|I got there in time for the train.
他用斧頭重重的斬了一下那棵樹就倒了下來|The tree was felled with one hard blow of his ax.
他父母搬回鄉下去了|His parents are moving back to their home town.
我們需要多一點咖啡|We need some more coffee.
我去过巴黎|I have been to Paris.
我們把所有的材料放在一起|We got all the materials together.
我以前常去打羽毛球但現在不打了|I used to play badminton, but I don't anymore.
我在家裡|I am in the house.
他在演奏音樂|He is playing music.
我对语言很感兴趣|I'm very interested in languages.
我問過他|I have asked him.
死刑在美国的很多州都被废除了|The death penalty had been done away with in many states in the USA.
明天我会问他的|I'll ask him tomorrow.
你不能在電視上罵粗口|You can't say four-letter words on TV.
請滿點說|Please speak slower.
我想在酒店的保险柜里存点东西|I'd like to put some things in the hotel safe.
他常常載我去兜風|He often takes me for a drive.
我啥也沒說|I didn't say a word.
不你说|No, you say.
她两眼于墨黑|Her eyes are dark.
Tom会做面条|Tom knows how to make noodles.
瓶子裏只剩下一丁點牛奶|There was only a little milk left in the bottle.
我沒看見Stefan|I didn't see Stefan.
我们认为这不严肃|We don't think it's serious.
我对他的态度变了|My attitude towards him changed.
今天晚上我玩得很開心|I had a good time this evening.
街道上擠滿了人|The street was crowded with people.
我真想在 Tatoeba 寫很多很多的句子不過我有別的事要做|I would love to write hundreds of sentences on Tatoeba, but I've got things to do.
他们给了他逃脱的机会|They gave him a chance to escape.
我被邀請參加他們的婚禮|I was invited to their wedding.
让我们回家吧|Let us go home.
她有一颗纯洁的心|She has a pure heart.
政府的开支有些过头了|The government's expenditures are a bit excessive.
这里现在有了许多新建筑|There are a lot of new buildings here now.
她不是這間公司正式的職員|She's not a regular employee of this company.
玛丽在研究上成功了|Mary succeeded in her studies.
汤姆有三个姐姐|Tom has three older sisters.
我们抓住了小偷|We captured the thief.
他祖母看起來很健康|His grandmother looks healthy.
我不喜欢搭便车|I don't like hitchhiking.
一直向前走|Keep going straight ahead!
您是从哪个学校毕业的|From what school did you graduate?
就在那时公交车停住了|Right at that instant, the bus stopped.
你还认识我吗|Do you know me?
我對其他人的意見並不關心|I am indifferent to others' opinions.
湯姆害怕待在洞穴裏|Tom was afraid to stay in the cave.
我不能再走了|I can't go any farther.
我不认为汤姆是我的朋友|I don't consider Tom my friend.
晚飯後你不可以外出|You must not go out after dinner.
不我很抱歉但我必须早点回去|No. I apologise, but I need to leave a bit early.
你每天都是做一模一樣的東西難道不會覺得悶嗎|I wonder if you don't get tired of doing the same thing every day.
你得等下一班公車|You must wait for the next bus.
放开我你正在掐着我的脖子|Let me go, you're choking me.
他終於露出馬腳了|He has finally shown his true colors.
史密斯太太坐車去教堂|Mrs. Smith goes to church by car.
那位女士说土耳其语吗|Does the lady speak Turkish?
水龙头在滴水|The faucet is leaking.
我的祖父非常健康|My grandfather is very healthy.
不正确的命题听起来可能符合逻辑|An argument may be logically sound without being true.
他贫穷但幸福|Poor as he is, he is happy.
他說會發生的事情已經發生了|What he said would happen has happened.
我開一輛敞篷車|I drive a convertible.
不要太炫耀这个了|Stop being so arrogant about this.
这些日子我们勉强糊口|We lived from hand to mouth in those days.
密西西比在哪|Where is Mississippi?
傑克對畫畫感興趣|Jack is interested in painting.
从这里坐车要花两个小时才能到我叔叔家|By car, it takes 2 hours to get to my uncle's house.
請澆花|Please water the flowers.
我應該拿那些錢的|I should have taken the money.
合上书|Close the book.
還有很多東西要做|There's still a lot to do.
他靠寫作謀生|He earns his living by writing.
你最近看過他嗎?|Did you meet him recently?
我的父亲是个好人|My father is a good person.
湯姆喜歡打棒球|Tom likes to play baseball.
我會給你這個墜飾|I'll give you this pendant.
請隨意吃水果|Please help yourself to some fruit.
他们的母语是法语|French is their mother tongue.
母親去了逛街|Mother has gone shopping.
那么你频道换掉也行啊|Can't you just switch channels?
你可以再說一遍嗎|Could you repeat that?
这让我大吃一惊|This has shocked me.
該法案在眾議院爭議後獲得通過|The bill was passed after a hard fight in the House.
他常常在那裡吃早餐|He often eats breakfast there.
現在是十時正|It's ten o'clock sharp.
他对西装和领带的选择非常挑剔|He's picky about suits and ties.
我們要建避難所|We're going to set up shelters.
你為甚麼需要我幫助|Why do you need my help?
本住在新加坡|Bin lived in Singapore.
他们已经做过了|They already did that.
他弄丢了电影票|He lost his movie ticket.
我看见你做饭了|I saw you cooking.
工程要怎么见效|How will the project work?
我幹嘛在跟你叨叨這些|Why am I telling you all this?
湯姆總是讓我笑|Tom always makes me laugh.
共产主义必胜|Communism will win!
我們會把一部分籌得的款項用來幫助殘疾兒童|A portion of the proceeds will go to benefit children with disabilities.
我要一间有淋浴的单人间|I'd like a single with a shower, please.
威廉是从巴西来的他是巴西人|Guilherme is from Brazil. He is Brazilian.
和我唱首歌|Sing a song with me.
我不知道乡愁的滋味|I don't know what it's like to be homesick.
无人领取的物品被拍卖了|The unclaimed items were sold off at auction.
紐約警察穿深藍色制服|The New York City police wear a dark blue uniform.
我们请女孩带着募捐箱来到舞台|Would the girls please bring the donation boxes up to the stage?
很高興認識你|Nice to meet you.
她把钱全给了他|She gave all her money to him.
他们喝可乐|They drink coke.
那个艺术家永远保持着赤子之心|The artist is eternally a boy.
我買了一本書|I bought a book.
我打算與她分手|I plan to break up with her.
我对你不感兴趣|I'm not interested in you.
他不再工作于此|He no longer works here.
这块地毯是手工制作的|This rug is handmade.
没有人相信我|No one believes me.
汤姆和玛丽看起来很喜欢这场派对|Tom and Mary look like they're enjoying the party.
归我了|Dibs.
我的男朋友在哭|My boyfriend is crying.
请坐一下|Please have a seat.
這盒草莓不太新鮮了|This punnet of strawberries isn't too fresh any more.
有个女生用一个橙子跟我换了一块蛋糕|A girl gave me an orange in exchange for a piece of cake.
我们不这样认为|We don't think so.
你會說納美語嗎|Can you speak the Na'vi language?
那是, 她是個貧窮的舞者|That is, she is a poor dancer.
他们等得了|They can wait.
你用那本書做什麼|What did you do with that book?
您的书很有意思|Your book is interesting.
汤姆参加了讨论|Tom joined the discussion.
我马上过去!|I'll be right there.
你难以理解女人和小孩子对你说的话吗|Do you have difficulty understanding what women or small children say to you?
你认为谁会赢得比赛|Who do you think is going to win the match?
難怪你這麼生氣|No wonder you're so upset.
我的蘋果汁在哪?|Where's my apple juice?
我不知道現在幾點鐘|I don't know what the time is.
我的钢笔不像你那支那么好|My pen isn't as good as yours.
我想它太大了|I think that it's too big.
我想我今晚會洗澡|I think I'll take a bath tonight.
現在它是官方的了|Now it's official.
你应该更小心的|You ought to have been more careful.
市中心有很多旅馆|There are many hotels downtown.
他總是跟她站在同一邊|He always takes sides with her.
他還沒寫信|He hasn't written the letter yet.
肯想要一輛腳踏車|Ken wants a bicycle.
全世界都知道|The whole world knows that.
我在等待批准|I am waiting for approval.
他跟她说这样的话真是太残忍了|It is cruel of him to say such things to her.
我的胃是脹滿的|My stomach's full.
汤姆说他愿意帮忙|Tom says he's willing to help.
你放学以后干什么|What do you do after school?
你無論用甚麼方法結果都是一樣|However you do it, the result will be the same.
他过去认识她但他们现在不再是朋友了|He once knew her, but they are no longer friends.
他不會長壽|He won't make it to old age.
汤姆和我差不多高|Tom and I are about the same height.
我認為我們要一起做|I thought that we were going to do this together.
他快要睡了|He was just on the verge of going to sleep.
毋庸置疑|Indubitably.
这个词是什么意思|What is the meaning of this word?
但是您有孩子|But you have kids.
我再也不喜欢你了|I don't like you anymore.
我很高興能夠認識您|I am glad to make your acquaintance.
卷起你的袖子|Roll up your sleeve.
玛丽是个埃及学家|Mary is an Egyptologist.
你应该做一个外交官|You should be a diplomat.
這家出版社專門出版兒童文學|This publisher specializes in children's literature.
我们喝了很多|We had a lot to drink.
有些人只能成為朋友|Some people must be friendzoned.
我做不到|I can't do that.
看来他的失败和他的性格有关|His failure seems to have something to do with his character.
他从头到脚都湿透了|He was soaking wet from head to toe.
从上海坐火车到郑州需几个小时|How long would a train from Shanghai to Zhengzhou take?
别怕犯错啊|Don't be scared of making mistakes.
平流層的臭氧會吸收紫外線|The ozone in the stratosphere absorbs ultraviolet radiation.
这样好多了|This is much better.
他们送孩子去了幼儿园的半托班|They send their child to a part-time nursery.
你覺得湯姆知道瑪麗已經結了婚了嗎|Do you think Tom knows Mary is married?
汤姆的上司真的非常生气|Tom's boss was really angry.
你不要死心|Don't lose hope.
意义的原句是相反|The original sentence means the opposite.
汤姆让我把门关上|Tom asked me to shut the gate.
我是猫|I am a cat.
把你的答案和老师的比较一下|Compare your answers with the teacher's.
谁比较高你还是我|Who's taller, you or me?
这个世界语句子是什么意思|What does this Esperanto sentence mean?
我告诉过你不要叫我“汤姆”吧|Haven't I told you not to call me "Tom"?
我是這船的船長|I'm the captain of this ship.
这太可怕了|That's terrible.
我不知道我該哭還是該笑|I don't know if I should cry or laugh.
她是一个奇怪神秘和鼓舞人心的诗人|She's a strange, enigmatic and inspiring poet.
起初我不相信他|I didn't believe him at first.
这间教室与那间隔着一堵墙|This classroom is separated from that one by a wall.
說英語的時候不要怕犯錯|Don't be afraid of making mistakes when speaking English.
不要超速|Don't go over the speed limit.
不要害怕發問|Don't be afraid to ask questions.
她不想吃午飯|She was in no humor for lunch.
这是很严重的病|It's a very serious illness.
請讓我看看你的袋子|Please show me your bag.
这是鸟类庇护所|This is a bird sanctuary.
他一到伦敦就给我发了个电报|On his arrival in London, he sent me a telegram.
我現在就要它|I want it now!
奶奶送了我們一箱蘋果|Grandmother sent us a box of apples.
欧洲人统一有可能吗|Is a common European identity possible?
你可以坐你想坐的任何地方|You can sit wherever you want.
把蛋放入沸水中|Put the egg into boiling water.
她对丈夫说“停下”|She said to her husband: "Stop!".
我們老師開車來學校|Our teacher comes to school by car.
选择合适的卫星图做为底图|Choose a suitable satellite image as the base map.
我父亲住在名古屋有30年了|My father has been living in Nagoya for 30 years.
这是火车站吗|Is that the railroad station?
你怎样让你的孩子们吃蔬菜|How do you get your children to eat vegetables?
那辆车十分新|That car is quite new.
不方便的相反詞是方便|The opposite of "inconvenient" is "convenient".
你们俩在同一所学校|Do you guys go to the same school?
那女孩跟我微笑打招呼|That girl smiled and waved to me.
我母親給我弟弟買了把黃色的雨傘|My mother bought my brother a yellow umbrella.
我一點也不在意別人的看法|I don't care the slightest bit what others think.
那不太可能|That would be unlikely.
我母親的筆跡很好看|My mother has good handwriting.
从华盛顿乘火车可以到纽约|New York is accessible by train from Washington.
她不来了|She didn't come.
要不是当初有内战他们现在应该挺富裕了|If it had not been for civil war, they would be wealthy now.
這是去帕克里奇的巴士|Is this the bus for Park Ridge?
肯和托尼谁跑得更快|Who runs faster, Ken or Tony?
我爸爸不是西班牙人是葡萄牙人|My father is not Spanish, he is Portuguese.
瑪麗跟班上其他女孩不一樣|Mary isn't like the other girls in the class.
看來湯姆借了輛自行車|It looks like Tom has bought a new bicycle.
一切规则都有例外|Every rule has exceptions.
Tom还是个小男孩|Tom is still just a boy.
他考試沒過但他不是特別在意|He didn't pass the exam, but it doesn't bother him.
这只松鼠对坚果过敏|This squirrel has a nut allergy.
多数人每天至少刷两次牙|Most people brush their teeth at least two times a day.
他说他每天早上六点起床|He said that he gets up at 6 o'clock every day.
他回来了|He came back.
这首歌让我想家了|The song reminds me of my home.
幫她|Help her!
不是这不是我的车|No, this is not my car.
她心不在焉的把車子撞在了柱子上|By lack of attention, she hit the post with her car.
身着西装他脱颖而出|Wearing a suit, he stood out.
万一我来晚的话就别等我了|If for some reason I'm late, please don't wait for me.
他明天將打棒球|He will play baseball tomorrow.
那時她正在做飯|She was cooking dinner at that time.
老张买了一件毛衣|Lao Zhang bought a sweater.
我怀疑他的故事|I doubt his story.
今天妈妈生日我订了一个蛋糕|Today is mom's birthday. I ordered a cake.
Tom只喝咖啡|Tom only drinks coffee.
我找到了托尼|I found Tony.
工業化常會導致環境污染|Industrialization often goes hand in hand with pollution.
你把我的行李怎么了|What did you do with my baggage?
他在哪家公司工作|What company does he work in?
瑪麗不管是多快的活兒妳都不應該不用菜板切菜|Mary, you shouldn't chop food without using a chopping board, no matter how short a time it is for.
這顆氣球被樹絆住了|The balloon was caught in the tree.
你们把自行车留下明天带着身份证和20块钱到交通局领自行车|Leave the bike here, and tomorrow bring your ID and 20 dollars to the Bureau of Communications to get the bike back.
汤姆告诉我他以为他会死在监狱里|Tom told me he thought he was going to die in prison.
他八个月大了已经开始长牙了他很高兴且几乎不会哭他吃得津津有味长得还有点胖嘟嘟的他已经开始尖叫了现在又想说话了|He is eight months old and already has a tooth. He is very cheerful and almost never cries. He eats with great gusto and is quite chubby. He is already trying to scream and wants to talk now.
请告诉我汤姆很好|Please tell me Tom is OK.
安靜|Be quiet!
這隻烏鴉飛走了|The crow flew away.
上星期我非常地忙|I was very busy last week.
他伸长了脖子希望能听到她们低声说的话|He craned his neck in the hope of hearing what they were whispering.
但是我一点儿肉也不吃|But, I don't eat even a little bit of meat.
不可能|No way!
我想错了|I was mistaken.
我现在很高兴|I'm very happy now.
這座城堡是甚麼時候建成的|When was the castle built?
父亲在浇花|The father is watering the flowers.
厨师把肉切碎了|The cook chopped the meat.
她很喜欢猫|She adores cats.
我们吃完了午餐|We have finished lunch.
我很高興他們修復了暖氣系統但現在太熱了|I'm glad that they fixed the heating system, but now it's too hot.
中国是一只沉睡的狮子一旦觉醒将会震惊世界|China is a sleeping tiger, but once it wakes up, it will shock the world.
六个人投了这份工作但他们中没有一个被录用|Six people applied for this job, but none of them was accepted.
请问这个手帕多少钱|How much is this handkerchief?
汤姆说玛丽觉得约翰下周末可能被允许那么做|Tom said Mary thought that John might be permitted to do that next weekend.
事故差点让他丢了性命|The accident almost cost him his life.
他以总统的身份访问了日本|He visited Japan in the character of President.
我們的愛是相互的|Our love is mutual.
你在做甚麼|What are you on about?
他闭上了眼睛|He closed his eyes.
我不準備和蘇西結婚|I'm not about to marry Suzie.
你们必须回家|You have to go home.
你什么时候离开|When will you leave?
他仅凭借精神力量和意志力就达到了他所想要的生活|He got where he wanted to be in life by just using his raw mental strengh and his mental willpower.
她确实喜欢动物|She really does like animals.
你應該六點前回家|You should come home before six.
我赢了|I won!
这个消息让我感到不安|The news left me uneasy.
汤姆是我朋友的朋友|Tom is a friend of my friend's.
請告訴我該怎麼做|Please tell me what to do.
选举一致通过了|The vote is unanimous.
這風景美得無法形容|The scenery was beautiful beyond description.
天氣很熱把電風扇拿來|It is hot. Bring the electric fan.
我除了星期天外每天都上班|I work every day save Sundays.
我有一個住在波士頓的朋友|I have a friend living in Boston.
她給她的狗洗了澡|She washed her dog.
雖然我失敗了但我會再試一次的|Though I failed, I will try again.
湯姆把他的廚餘餵給他的狗吃|Tom fed his leftovers to his dog.
汤姆不尊重玛丽的观点|Tom doesn't respect Mary's opinion.
很快就會放睛了吧|It'll clear up soon.
那不關他的事|It's none of his business.
你爱音乐吗|Do you love music?
我找到你了没有么|I found you, didn't I?
有人说过不论黑猫白猫能捉到老鼠就是好猫但是现在一般人里很难见到老鼠了那么怎样的猫才是好猫呢|Some people say, regardless of whether it is a black cat or a white cat, if it can catch mice it is a good cat. However, nowadays ordinary people rarely ever have mice. Therefore, how can a cat be a good cat?
他为他的失败感到羞耻|He is ashamed of his failure.
他試著想讓他妻子開心但是沒有成功|He tried to make his wife happy, but in vain.
我正在尋找可以幫我修改這篇論文的母語人士|I am looking for a native speaker who can correct this paper for me.
他有時煮晚飯給我們吃|He sometimes makes dinner for us.
你這麼早來到幹甚麼|What did you come here so early for?
我哭笑不得|I don't know whether to laugh or cry.
Ken今天下午很忙|Ken is busy this afternoon.
不要擔心你辦得到的|Don't worry. You'll make it.
你今天最好不要出門|You'd better not go out today.
湯姆到了現在還沒來說不定是沒趕上火車|Tom may have missed the train. He hasn't come yet.
我要戴頭盔|I'd wear a helmet.
當你餓的時候任何東西都好吃|When you're hungry, anything tastes good.
想到自己的未来她不安起来|Thinking about her future, she is unsettled.
我确定它将会很有趣|I'm sure that it'll be fun!
要就要不要就拉倒|Take it, or leave it.
难民从整个国家涌来|Refugees poured in from all over the country.
這裡疼|I have a pain here.
凱特幾乎從未慶祝她的生日|Kate hardly ever celebrates her birthday.
起火原因不明|The cause of the fire is not known.
這本書好厚|This book is too thick.
没照片|No pictures.
我告诉汤姆我认为他的房子要刷漆|I told Tom that I thought his house needed to be painted.
你想死在這裡嗎|Do you want to die here?
您好吗|How are you?
冬天结束了|Winter is gone.
你应该找到他们|You'd better find them.
別忘了明天六時來接我|Don't forget to pick me up at 6 o'clock tomorrow.
应当多学东西|You should learn more.
我來自台北.|I come from Taipei.
哦真的嗎|Oh! Really?
史密斯先生是她的一个相识|Mr Smith is an acquaintance of hers.
我不想再花時間跟湯姆討論了|I didn't want to spend any more time arguing with Tom.
我很生气|I'm outraged!
中文学起来太容易了|Chinese is too easy to learn.
我今天去看演出了|I went to see a show today.
我没时间|I have no time.
两个女人唱着歌|Two women are singing.
他问我买了什么|He asked me what I had bought.
我们都清楚地知道我们的发展走向另外团队中每个人都有点随心所欲|We know very well where our developments will take us. Besides, in the team, everyone does as he pleases.
要小心那些说自己客观的人|Beware of anybody who claims objectivity.
他去歐洲旅行了|He took a trip to Europe.
这不可能|It can't be!
現在她沒了工作我們再不能依靠她了|Now that she has quit her job, we can't depend on her.
你还不够经验|You're still green.
别担心我确定我能找到其他的人|Don't worry, I'm sure that I can find someone else!
昨天舉辦了開幕式|The opening ceremony took place yesterday.
紐約的天氣怎麼樣|What's the weather like in New York?
你帽子在哪儿|Where's your hat?
很多人都参加了他的葬礼|Many attended his funeral.
我确实在这里丢了东西|I'm clearly missing something here.
我喜歡甜食|I like sweets.
我兒子相信聖誕老人|My son believes in Santa Claus.
湯姆和瑪麗亞到樹林裡採集蘑菇去了|Tom and Mary went into the forest to collect mushrooms.
我沒吃早餐所以肚子很餓|I am hungry because I did not eat breakfast.
走着瞧|Go and see!
汤姆每天都花八个小时看电脑|Tom sits in front of his computer eight hours a day.
你快要走了|You will be going soon.
世界语的创始人柴门霍夫是一个眼科医生|Zamenhof, the creator of Esperanto, was an ophthalmologist.
我父亲不允许我嫁给他|My father will not let me marry him.
你喜歡去電影院嗎|Do you like to go to the movie theater?
别哭|Don't cry.
汤姆承认他杀死了玛丽|Tom admitted killing Mary.
这种说法其实有点可疑|This statement is actually kind of suspicious.
事故发生在前天|The accident happened the day before yesterday.
不要小看自己因為人有無限的可能|Don't look down on yourself, because people have limitless possibilities.
她建議他多喝奶|She advised him to drink more milk.
说谎不好|Lying is wrong.
我对汤姆说我很好|I told Tom I was OK.
我想請你把這本書翻譯成英文|I would like you to translate this book into English.
这本书很简单|The book is easy.
我会带他们回家|I'll take them home.
我想和一个像她那样的女孩结婚|I want to marry a girl like her.
这个不贵|This is not expensive.
你赞成还是反对这个建议|Are you for or against the proposal?
挑选一个吧|Choose one.
太残忍了|That's very cruel.
坚持做对的事情这会满足一部分人同时使另一部分人感到惊讶|Always do right. This will gratify some people and astonish the rest.
我昨天喝多了|I drank too much yesterday.
我认为汤姆一点教学经验都没有|I don't think Tom has any teaching experience.
她很生气地把鞋子袜子脱掉|She threw off her shoes and socks in anger.
我愛看脫口秀|I love watching talk shows.
还有什么想要的吗|Is there anything else you want?
汤姆喜欢玛利亚吗|Does Tom like Maria?
因为缺乏的政府的关注这个区域还不发达|This area is still underdeveloped because of a lack of interest from the government.
客人很多大部分都是老师的同学和朋友|There were many guests - most of them were our teacher's classmates and friends.
我想再来一杯啤酒|I would like another beer.
汤姆可能已经走了|Tom may have left already.
这件衬衫我不喜欢把另外一件给我看一下|I don't like this shirt. Show me another.
我挣扎着挤出地铁|I struggled to get out of the subway.
我不知道她想不想和我一起去|I don't know if she wants to go with me.
我没有名字|I don't have a name.
把收音機調大聲點我聽不清楚|Turn up the radio. I can't hear it.
沒有|Not in there.
我們才剛搬進來|We just moved in.
我一到機場就會打電話|I'll call as soon as I am at the airport.
我們沒麵包了|We don't have any bread left.
我写了一封情书给她|I wrote her a love letter.
苹果买不了了|You can't buy apples any more!
很多人說那是謊話|There are lots of people who say that's a lie.
他們怕這隻大狗|They were afraid of the big dog.
玛丽亚喜欢长途骑行|Maria likes long bike rides.
你就随了我的意吧|Humor me.
别擔心|Don't worry.
去拿一下报纸|Get me the newspaper.
如果明天天气好那么我们就去野餐|We'll go on a picnic if it's fine tomorrow.
他们说压力导致高血压|They say stress causes high blood pressure.
我们必须遵守规则|We have to abide by the rules.
世界上有10种人懂二进制和不懂二进制的人|There are 10 types of people in the world: those who understand binary, and those who don't.
我們的新家有一臺電梯|Our new home has an elevator.
我認為湯姆很可能會喜歡這部電影|I think Tom will likely like this movie.
看來沒有必要幫助這個國家|There seems no need to help that country.
他是一個友善的人|He is a friendly person.
它长着女人的头狮子的身体一双羽翅以及蛇尾巴|It had the head of a woman, the body of a lion, the wings of a bird, and the tail of a serpent.
一看到甜点我就无法自拔|When it comes to sweets, I just can't control myself.
不它们太小了|No. They are too small.
他头发长长的|He had long hair.
今天是三月五号|Today is March 5th.
谁担心汤姆|Who's worried about Tom?
韩国随着朝鲜的外患而在边界附近集结军队|As North Korea displays aggression, South Korea concentrates its forces near the border.
我是汤姆的父亲|I'm Tom's father.
你的房子有幾個廁所|How many toilets does your building have?
我寧願待在這裡而不去|I'd rather stay than go.
汤姆没能说服玛丽|Tom failed to persuade Mary.
您也是喀什人吗|Are you also from Kashgar?
拉丁文是宗教與文化的語言|Latin was the language of religion and culture.
它是什么|What is it?
“你看起来像游客”“可我就是游客”|"You look like a tourist." "But I am a tourist!"
他們看不見我|They can't see me.
我很累还没地方睡觉|I'm very tired and don't have a place to sleep.
昨天我十点去睡觉了|Yesterday, I went to bed at ten.
我应该读这本书|I should read the book.
火车什么时候到横滨|What time does this train reach Yokohama?
請不要那樣看我|Please don't look at me like that.
你有多少支铅笔|How many pens do you have?
这首歌也还可以吧|This song will do too?
你昨天晚上出去了嗎|Did you go out last night?
我刚才起床了|I just got up.
我们无法辨别哪个更好|We can't tell which is better.
他可能發生了什麼事情|Something may have happened to him.
要真正了解一个国家的语言和文化 就应该去那个国家学习和生活一段时间|If you want to truly understand the language and culture of a country, you should go to study and live in that country for a period of time.
患難見真情|A friend in need is a friend indeed.
我们是两个通情达理的人|We're both reasonable people.
我在市场营销部门|I'm in marketing.
您决定好要下订单了吗|Are you ready to order now?
玛丽给汤姆礼物|Mary offered Tom a gift.
融合爵士是搖滾樂與爵士樂的融合|Jazz fusion is a combination of rock and jazz.
真是精神可嘉|That's the spirit!
比爾能通過考試了|Bill was able to pass the exam.
我會晚一點回來|I will be back late.
我真後悔以前沒有好好對她|I wish I had treated the girl more kindly.
汤姆现在在我的办公室里|Tom is in my office right now.
这不是我的工作|That's not my job.
她在找工作和读大学之前无法取舍|She can't make up her mind whether to get a job or to go on to college.
你已經吃過飯了|You have already eaten.
为什么克里斯托弗·哥伦布离婚了 |What did Christopher Columbus discover?
還有什麼事就告訴我|Let me know when you need me again.
湯姆把日曆挂在墙上|Tom hung the calendar on the wall.
我們現在就需要走|We have to leave right now.
他们互相送礼物给对方|They give each other presents.
我會在下一站下車|I'm getting off at the next station.
那个在弹钢琴的女孩是我的妹妹|That girl playing the piano is my little sister.
財富並不總是為我們帶來快樂|Wealth does not always bring us happiness.
我的嗜好是有條件的給錢還有無條件的給感謝你的呢|My bad habit is to give money conditionally and to give thanks unconditionally. Yours?
是誰把窗打破了|Who broke the window?
他为什么之前住在美国|Why did he live in the United States?
我喜歡她這身黑色的裝束|I like her black clothes.
不要留下我一个人|Don't leave me alone!
分支和合併是版本控制的兩種基本操作|Branching and merging are two basic operations of revision control.
三月小姐給了我一本英語詞典|Miss March gave me an English dictionary.
他是教區委員會的成員|He is a member of the parochial board.
它現代化的程度遠遠超乎我的預料|Its modernization was far beyond my expectations.
亚美尼亚里没有海|There is no sea in Armenia.
她说她很健康|She said she's healthy.
警察起诉他盗窃|The police accused him of theft.
醫生告訴我, 我應該停止吸煙|The doctor told me I had to stop smoking.
世界上有超過一百五十個國家|There are more than 150 nations in the world.
他敲了門|He knocked on the door.
大廳裡有八十張椅子|The number of the chairs in the hall is 80.
这里夏天非常炎热|It is very hot here in summer.
他们要求市长辞职|They requested the mayor to resign.
她一舉成名|She suddenly became famous.
我见了一个朋友|I met a friend.
紐約的天氣如何|What's the weather like in New York?
你该学得更多|You must study more.
這個簽證的有效期限是多久?|How long is this visa good for?
她看起來好像有很多朋友|She appears to have a lot of friends.
你还在找工作吗|Aren't you looking for work?
我還沒決定|I haven't decided yet.
所有学科中我比较喜欢英语|I like English best of all subjects.
我在树林里迷路了|I've got lost in the forest.
我愿意接受建议|I'm open to suggestions.
世上有三種人會數數的和不會數數的|There are three kinds of people in the world: those who can count, and those who can't.
我一天挣一百歐元|I make 100 euros per day.
他在法國住了一段時間然後就去了意大利|He lived in France for some time, then went to Italy.
您什么时候开始学英语的|When did you begin studying English?
我不是魔法師|I'm not a magician.
他擅長駕駛|He is good at driving.
他是利茲大學的英文系教授|He is a professor of English at Leeds.
那不是猫那是狗|That's not a cat. It's a dog.
请向前一步|Please come forward.
紐約位在哈得遜河|New York is on the Hudson River.
飯前洗手|Wash your hands before each meal.
汤姆正在清扫人行道|Tom is sweeping the sidewalk.
我是个好厨师|I'm a good cook.
我被烦死了|I was quite annoyed.
數艘游艇在遠方的海洋並列航行|Several yachts were sailing side by side far out at sea.
汤姆忘了在测卷上写名字|Tom forgot to write his name on the test paper.
他来信了吗|Have you received a letter from him?
湯姆說他要把他知道的告訴我們|Tom said he's going to tell us what he knows.
花道是日本文化的一部分|Ikebana is part of Japanese culture.
請開燈|Turn on the light, please.
你家里人都还好吗|How is your family?
猫是黑色的|The cat is black.
这个孩子长大后成为了一个伟大的政治家|The boy grew up to be a great statesman.
我们没有足够的时间来完成手头的工作|We didn't have enough time to finish what we were doing.
那个茶壶很脏啊|That teapot's pretty dirty.
能借我支铅笔吗|Would you lend me a pencil?
你最好带上这个|You'd better take this.
我不能讓你去波士頓|I can't let you go to Boston.
这是湖的最深处|The lake is deepest at this point.
我不觉得他很诚实|I don't think he is sincere.
你看那邊正在冒煙那棟大廈一定是失火了|Look at that smoke. That building must be on fire.
我们五个之中肯定是他说的语言最多|Among the five of us, he's surely the one who can speak the most languages.
美金對埃磅多少啊?|How many US dollars are in an Egyptian pound?
老人试图游5公里|The old man attempted to swim five kilometers.
不先與我們的承包商討論的話我無法計算出最後的費用|I can't calculate the final cost without first discussing it with our contractors.
他把车停在大楼前|He parked his car in front of the building.
他去了美國讀美國文學|He went to America for the purpose of studying American literature.
床占了很多空間|The bed takes up a lot of space.
比赛什么时候开始|When does the game start?
剛出生的小雞還沒有睜開眼睛|The newborn chicks still have not opened their eyes.
开始多云了|It's getting cloudy.
修学旅行我们去了志贺高原滑雪|We went skiing in Shiga Kogen for our school trip.
我只能问自己这对其他所有人是不是一回事呢|I can only wonder if this is the same for everyone else.
我父亲戒烟了|My father stopped smoking.
你要尝尝吗|Would you like to try it?
湯姆說你從來沒去過澳大利亞|Tom says you've never been to Australia.
我一天花了500美元|I've spent 500 dollars in one day.
你必须选|You must choose.
她看起來可能有點畏首畏尾的但她的意志其實十分堅強|She seems timid, but she's actually a strong-willed person.
他是你們的王|He is your king.
我當然拒絕了|I refused, of course.
您的头发是什么颜色的|What color is your hair?
她向我们大声求助|She called out to us for help.
为什么没有人相信我|Why does no one believe me?
他可能是从另一条路回到了家|He might have returned home from another route.
她需要去那兒|She must go there.
天上没有一片云|There isn't a cloud in the sky.
我們已經贏得了這場戰鬥|We've already won this battle.
我可以獨自做|I can do it alone.
你看都出血了我扶你起来吧|You're bleeding everywhere; I'll help you up.
欢迎!|Welcome!
有隻蝴蝶在廚房裏|There is a butterfly in the kitchen.
我沒趕上火車|I didn't catch the train.
夕阳西下|The sun is going down.
放下你的手|Put your hands down!
所有月份中我最喜歡五月|I like May the best of all the months.
我不想辞去这份工作|I do not want to leave this job.
他游泳比我好|He is a better swimmer than I.
可以耽误你一点时间吗?|Have you got a minute?
他被冻死了|He was frozen to death.
出席的學生不下五百人|No fewer than five hundred students were present.
我不太確定|I can't say for sure.
天黑之后他从不出门|He never goes out after dark.
战争永远谈不上好和平永远谈不上坏|There never was a good war nor a bad peace.
我的右眼瞎了|I'm blind in the right eye.
母亲做了的蛋糕是我吃了的最好的|The best cakes that I have ever eaten are those that my mother baked.
球员们坐在更衣室听教练给他们打气|The players sat and listened to their coach give them a pep talk in the changing rooms.
市長一家人一整天不斷遭到了恐嚇電話的騷擾|The mayor's family was harassed with threatening phone calls all day.
這本書昨天在他的車上|This book was in his car yesterday.
錯|Wrong.
你们有没有纸|Do you have paper?
那儿有笔?|Where is a pen?
你写吗?|Did you write?
她建议他使用脚踏车|She advised him to use a bicycle.
没有什么东西比复仇更昂贵更无益|There is nothing which exacts a higher price than revenge, yet is so futile.
因为酷暑一直持续着请谨防食物中毒|Hot weather will continue, so please watch out for food poisoning.
他发疯了|He's a psycho.
保羅用手從頭髮間梳過|Paul ran his hand through his hair.
他老婆很有才|His wife is quite a talented woman.
吃过了没|Have you eaten yet?
我們在罷工|We are on strike.
狗跟我一起睡在床上|My dog slept in the bed with me.
你是个好厨师|You're a good cook.
你是我所知道的最聪明的人|You're the smartest person I know.
我剛吃過午飯|I've just had lunch.
你是不是刚认识他|Did you just get to know him?
你知道这是谁的吗|Do you know whose this is?
我在想有多少加拿大人住在波士頓|I wonder how many Canadians live in Boston.
我想是在沙漠里|In the desert, I think.
毫无疑问|There's no doubt.
你觉得我之前在做什么|What do you think I was doing before?
我来自日本|I come from Japan.
這一個還活著|This one's still alive.
你能够说出一首他们的歌的名字吗|Can you name one of their songs?
你的父母很愛你|Your parents loved you very much.
我非常喜欢英语|I like English very much.
回家|Go home!
他想要正义|He wants justice.
你买了花儿没有?|Did you buy flowers?
我乘車去了海邊|I've been to the seaside by car.
我肯定忘了带雨伞但现在已经太迟了|I must have forgotten my umbrella, but it's too late now.
我昨天去了醫院|I went to the hospital yesterday.
你们是在哪里认识的|Where did you meet?
这家饭馆下午的时候往往没有很多顾客|Not many customers come to this restaurant in the afternoon.
我現在可以回家嗎|Is it OK if I go home now?
我时间有点来不及只能出门买大饼油条|I'm running a little short on time, so I can only go out and buy flat bread and bread sticks.
聽說他又開始找工作了|I hear he's just begun looking for another job.
她缺乏常识|She is lacking in common sense.
请帮我找到他|I need you to find him.
今天没昨天冷|It's not as cold today as it was yesterday.
我经常使用SSH来远程连接到我的电脑|I often use SSH to remotely connect to my computer.
她说她每天早上六点起床|She said that she gets up at six every morning.
法国队守门员扑到地上截住了罗纳尔多的射门|The goalkeeper for France dived to the ground and saved Ronaldo’s shot.
有人把他们的雨伞落在走道里|Someone left their umbrella in the hall.
我遇到的人都很仁慈|The people whom I meet are kind.
我讓他修理我的車子|I got him to repair my car.
饭好了|Food's ready!
他因谋杀罪被绞死|He was hanged for murder.
她下樓|She was coming down the stairs.
我很滿意我的工作|I'm satisfied with my work.
湯姆威脅過你嗎|Did Tom ever threaten you?
罐子是空的|The jar is empty.
我比你漂亮|I am more beautiful than you.
消防隊很快就把大火撲熄|The firemen quickly extinguished the blaze.
請先不要掛上電話|Please do not hang up the phone.
我痛恨他的黄段子|I really hate his dirty jokes.
坐這邊|Sit over here.
我和金同年|Kim and I are the same age.
如果他們知道會發生那樣的事一定會改用別的計劃的|If they'd known what was about to happen, they would've changed their plans.
我尊重他这位作家也尊重他这个人|I respect him as a writer and as a man.
老人小心翼翼地过了马路|The old man walked across the road carefully.
我總是走路到學校|I always walk to school.
亚洲比澳洲大很多|Asia is much larger than Australia.
今天早上我耳朵流血了|My ear was bleeding this morning.
我期待收到您的來信|I'm looking forward to hearing from you.
這讓人難以置信|This is difficult to believe.
有過半數的居民反對這個計劃|More than half of the residents are opposed to the plan.
Jim为她用钢琴伴奏|Jim accompanied her on the piano.
在那裡見我|Meet me there.
我走了啊|I am leaving.
她答应不会伤害他|She promised him she wouldn't hurt him.
我在找关于古罗马历史的书|I'm looking for books on Roman history.
别吃得这么快|Don't eat so fast.
检点一下工具看有无丢失|Check the tools and see if anything is missing.
湯姆在外頭鏟雪|Tom is shoveling snow outside.
我拉肚子了|I have diarrhea.
重新來過吧|Start over.
你会吹口哨吗|Can you whistle?
我是學生|I'm a student.
我知道你已经等很久了但你能再等一小会吗|I know you've been waiting a long time, but could you wait just a little bit longer?
你在看什麽|What are you eyeing?
他停下来好穿鞋|He stopped to put on his shoes.
我的爱人很会做饭|My lover is great at cooking.
即使我承认你说的是真的但这并不是借口|Even if I grant that what you say is true, it is no excuse.
我觉得汤姆有可能会来|I think it's possible that Tom may come.
我請媽媽四點叫我起床|I asked Mother to wake me up at four.
對許多男同性戀者來說出櫃是一個困難的經歷|For many gay men, coming out of the closet is a difficult experience.
湯姆很耐痛|Tom has a high threshold for pain.
湯姆答應會來但他沒來|Tom promised that he'd come, but he didn't.
英語已經普及全國|English has spread all over the country.
也许我会马上放弃然后去打盹|Maybe I'll just give up soon and take a nap instead.
他伸长了脖子希望能听到她们低声说的话|He craned his neck a bit in hopes of hearing what they were whispering.
我有點不舒服|I'm not quite well.
他開了先河|He set a precedent.
我们队从来就没赢过|My team is always losing.
我没有忘|I didn't forget.
一分钟有六十秒|There are sixty seconds in a minute.
“滚石不生苔”是一句谚语|"A rolling stone gathers no moss" is a proverb.
瑪麗似乎對這個遊戲感到無聊|Mary seems to be bored of this game.
你這樣做是錯的|You're doing it the wrong way.
我不想再聽到你的抱怨了|I don't want to listen to you complaining again.
爸爸恢复了健康|Father recovered his health.
您今天早上醒來的時候您的眼皮有沒有粘在一起|Were your eyelids stuck together when you woke up this morning?
他就像井底之蛙|He is like a frog in a well.
我覺得我們可以做朋友|I think that we can be friends.
醫生建議我父親少吸煙|The doctor advised my father to cut down on smoking.
她热泪盈眶|Tears filled her eyes.
我以身為這個計劃的一份子為榮|I am proud to be a part of this project.
“我不能抓我的主人”猫说|"I cannot claw my owner", said the cat.
小心切到手|Carefully cut it while holding it in your hands.
我家很大|My house is big.
如果一只老虎突然出现在我面前我肯定吓死了|If a tiger suddenly appeared in front of me, I'd be scared to death.
你是哪国人|Where do you come from?
噓|Hush!
我在這裡等她|I'm waiting for her here.
城堡的遗迹现在变成了公园|The site of the castle is now a park.
公平点|Be fair.
你给我下来|Come down here!
在加拿大有人说法语吗|Are there French speakers in Canada?
很便宜是吗|That's cheap, isn't it?
她是一個妓女|She is a prostitute.
这两个双胞胎兄弟长得一模一样|These twin brothers are as alike as two peas in a pod.
花園裡沒有任何玫瑰|There weren't any roses in the garden.
我從昨天開始一直忙著|I have been busy since yesterday.
你不是音乐家|Aren't you a musician?
你多大了|How old are you?
我来啦|I'm coming.
我到達倫敦了|I arrived in London.
盒子裡有什麼呢?|What is inside the box?
从马德里来的人都很怪|People from Madrid are weird.
友善点|Be kind.
对面的房子是总统的度假房|The house across the street is the president's vacation home.
George學葡萄牙文多久了|How long has George studied Portuguese?
她決定辭去工作|She decided to quit her job.
他今年畢業嗎|Is he graduating this year?
他在哪買了那本書|Where did he buy that book?
这里的自然景观的特点是山非常多而且像画一样特别美|The natural landscape is characterised by its large amount of mountains, and it looks as truly beautiful as a painting.
我今天有很多事要做|I have a lot of things to do today.
我們打了一場雪球大戰|We had a snowball fight.
问题在于金钱没有时间那样重要|The problem is that the money is not of such importance as the time.
我要搭10:30的火車|I'm going to take the 10:30 train.
Tom把除了厨房水槽之外的所有东西都打包了|Tom seems to have packed everything but the kitchen sink.
我来了|I'm coming!
我们有你的尺寸但是没有那个颜色|We have your size, but not in that color.
我们很高兴今晚能见到大家|We take great pleasure in meeting all of you this evening.
你不能進來|You may not come in.
他們在圖書館裝備了新的書籍|They furnished the library with new books.
他是个很难相处的男人|He is a man hard to get on with.
这些天我的视力正在变差|My vision is getting worse these days.
我们住在郊区|We live in the suburbs.
那個店裡沒有合我尺寸的帽子|There are no hats in that store that fit me.
你不要用嘴呼吸用鼻呼吸|Breathe through your nose, not your mouth.
要是給他知道你要結婚的事他肯定會大發雷霆|Should he hear of your marriage, he will be furious.
我們是老朋友|We're old friends.
現在父親在他的辦公室已經得到了一個上級的地位|Father has now got a superior position in his office.
這個牌子的漱口水的味道好怪|This brand of mouthwash tastes funny.
我经常做噩梦|I often have bad dreams.
你會在哪裡|Where will you be?
吉米堅持要我帶他去動物園|Jimmy insisted on my taking him to the zoo.
我想要离开这里|I wanna get out of here!
我在街上遇到我的老師|I greet my teacher on the street.
生命是一種致命的性傳染病|Life is a sexually transmitted terminal disease.
啊我們沒有糖了|Ah, we have run short of sugar.
很多士兵在这场战役中严重受伤|Many soldiers suffered terrible wounds in the battle.
保羅去年賺了很多錢|Paul made a lot of money last year.
老人採取了傲慢的態度|The old man assumed an impudent attitude.
请你不要再哭啦|Please stop crying.
你有孩子嗎|Do you have children?
汤姆比玛丽大三岁|Tom is three years older than Mary is.
我的鸡巴很大|I've got a big dick!
這是一幅地圖|This is a map.
您是否知道明天会不会下雨|Do you know whether or not it will rain tomorrow?
這與你無關|This has nothing to do with you.
大海是蓝色的|The sea is blue.
救助人员将为地震受灾者提供资助|The rescue workers are going to hand out supplies to the victims of the earthquake.
請給我一杯水|I'd like a glass of water, please.
他把他的手从桌上移开了|He withdrew his hand from the table.
你在哪兒寫|Where do you write?
走開|Go away!
你走了我會很想你|I'll miss you very much if you go.
我们学校在市中心|Our school is in the center of the town.
那辆山地车多少钱|How much is that mountain bike?
我要再做一次|I must do it again.
是誰讓她來的|Who asked her to come?
你另一个弟弟在哪里|Where is your other younger brother?
他生病了|He is sick.
看完这封信请把它烧掉|Burn this letter after you finish reading it.
窗戶是關著的嗎|Was the window closed?
我真的认为汤姆和玛丽不在乎|I honestly don't think Tom and Mary care.
幸福的家庭都是相似的不幸的家庭卻各有各的不幸|Happy families are all alike; every unhappy family is unhappy in its own way.
隨地吐痰在新加坡算是犯罪行為|In Singapore, it is a crime to spit on the ground.
他犯下了多项罪行|He committed multiple crimes.
汤姆错了|Tom was wrong.
乔拜登偷了我的自行车|Joe Biden stole my bicycle.
今天相當暖和|It's fairly warm today.
但最重要的是我永远不会忘记这场胜利真正属于谁它属于你们它属于你们|But above all, I will never forget who this victory truly belongs to. It belongs to you. It belongs to you.
我不太喜歡這水果的氣味|I don't like the way this fruit smells.
那座建築物就是我們的學校了|That building is our school.
他逃了阿尔及利亚|He fled Algeria.
我不喜歡在泳池裏游泳|I don't like to swim in pools.
我們必須取消我們去日本的旅行|We must cancel our trip to Japan.
約翰相比平時早起了好多|John got up much earlier than usual.
我要花很长时间|It'll take a long time.
你可以握住我的手|You can hold my hand.
你怎麼沒親她|Why didn't you kiss her?
第一次世界大戰於1914年爆發|World War I broke out in 1914.
想得好!|Good thinking!
绝对将要下雨|It'll rain for sure.
不用特地來我家了|Do not bother to come to my home.
湯姆在瑪麗亞的儲物櫃裡留下了一張紙條|Tom left a note in Mary's locker.
她躺在桌子上|She is lying on the table.
人不是为失败而生的, 一个人可以被毁灭, 但不能给打败|But a man is not made for defeat. A man can be destroyed but not defeated.
沒有人知道東京甚麼時候會發生大地震|No one knows when a severe earthquake will strike Tokyo.
我想买半个蛋糕|I'd like to buy half a cake.
如果你想要那把水槍你必須自己存錢買我沒有辦法一直買玩具給你錢不會從我背上長出來|If you want that water pistol you'll just have to save money and buy it yourself. I can't constantly buy toys for you. I'm not made of money.
我见了罗伊他叫我把这个转交给你|I saw Roy and he asked me to pass this along to you.
书散落在房里|Books are scattered around the room.
哀莫大于心死|Nothing is more sad than stupidity and apathy.
你的椅子和我的很像|Your chair is similar to mine.
这种面包很美味|This bread is very delicious.
上帝不存在|God doesn't exist.
你有看见过汤姆生气的时候吗|Have you ever seen Tom mad?
我今天看见他们了|I saw them today.
由美昨晚讀英語|Yumi studied English last night.
谁不喜欢反叛者呢|Who doesn't love a rebel?
把她干掉了|Get rid of her.
他为死去父报了仇杀他|He killed him to avenge his dead father.
今天我终于鼓起勇气对她说“我爱你”|Today I finally worked up the bravery to say to her "I love you!"
让我们玩耍吧|Let's play.
我们边喝茶边等|We're drinking tea and waiting.
你可以在年鑑中找到月相的資訊|In an almanac you can find information about the phases of the moon.
这计划如何|How is this plan?
我在一个小镇长大|I grew up in a small town.
要不要買個無線鼠標呢|Should I buy a wireless mouse?
我十一点上床|I go to bed at eleven.
湯姆沒再見過她|Tom never saw her again.
电影院有多少人|How many people were there in the cinema?
她在離市中心不遠處租了間公寓|She rented a flat close the to the city centre.
人們似乎只在夏天烤肉|It seems that most people only barbeque in the summer.
她羞怯地看了一眼那個年輕人|She cast a shy glance on the young man.
他在寫申請書呢|He's writing an application.
從中選擇一人|Choose one person.
现在的贷款利率很高|Interest on loans is high at present.
她不喜欢不守时的人|She doesn't like people being late.
這個男孩有一張紅潤的臉|The boy had a red face.
你的皮膚真好|You have nice skin.
以后再讲|Let's talk later.
這件大衣沒有袋子|The coat doesn't have any pockets.
汤姆真的不会游泳吗|Is it true that Tom can't swim?
尽管事故使进度延迟了一个月我们还是设法赶上了日程表|Although the accident has delayed progress by one month, we have managed to catch up with the schedule.
这份职位要求应征者有一定的英语口语表达能力|The position requires applicants to be skilled in spoken English.
他比我高|He is taller than I.
是什么原因呢|What's the reason?
克服弱点|Overcome weakness.
我无法忘记那天发生了什么|I can't forget what happened that day.
他最终同意了我们的计划|He finally agreed to our plan.
猫有两只眼睛|Cats have two eyes.
澳洲最大的城市是什么|What's Australia's largest city?
站在那儿的女人是谁|Who is the woman standing there?
這雞肉是粉紅色的|The chicken is pink.
汤姆在医院的等候室|Tom is in the hospital waiting room.
我不觉得它很好|I don't think that it's good.
我最好的朋友舞跳得很好|My best friend dances really well.
夏里斯太太對她兒子的前途沒有甚麼信心|Mrs. Harris is very doubtful about her son's future.
我的內衣髒了|My underwear is dirty.
她朝我丢葡萄我试着用嘴接住它们|She tossed me grapes and I tried to catch them with my mouth.
如果您不愿意的话就不必回答|If you are not willing to speak, then you do not have to answer.
栗子至少要煮15分钟|Boil chestnuts for at least 15 minutes.
搞什么啊|What are you doing?
这条河是欧洲最宽的|The river is the widest in Europe.
他有超过一百万美元的资产|He has over a million dollars in assets.
所谓陌生人只是还未相见的友人而已|A stranger is just a friend you haven't met yet.
湯姆把飲料洒到了自己身上|Tom spilled his drink on himself.
实际上他根本没有去考试|The fact is that he didn't even take the exam.
现在电视台正在播放足球赛|The football game is now on the air.
我六點起床|I get up at six.
他聰明到不會娶她|He knows better than to marry her.
您可以使用此电话|You can use this phone.
抱怨不會改變任何東西|Complaining won't change anything.
這件物件的表面頗為粗糙|The surface of the object is fairly rough.
海豚是十分聰明的動物|The dolphin is a very intelligent animal.
我不是一個句子我應該從Tatoeba當中被刪除掉|I'm not a sentence. I should be deleted from Tatoeba.
好大一颗钻|The demand is huge.
她是谁|Who's she?
湯姆和南西上個月分手了|Tom and Nancy broke up last month.
“我们的火车九点就开了”“别担心我们会准时到的”|"Our train leaves at 9:00." "Don't worry. We'll make it."
托尼打網球打得真好啊|What a good tennis player Tony is!
我还在看|I am still reading.
意外中有十個人受了傷|Ten people were injured in the accident.
有时候我会想吃辣的东西|Every now and then I like to have hot and spicy food.
要是你来得了那就太好了|If you came, that would be great.
跑啊|Run!
不收小費|We don't accept tips.
这咖啡对我来说太浓了|As far as I'm concerned, this coffee is too strong.
第一班火车什么时候出发|What time does the first train leave?
这将永远继续下去|This is never going to end.
我很忙|I am busy.
油表是什麼時候壞的|When did the petrol gauge stop working?
在麻醉剂的作用下他昏了过去|He lost consciousness under the influence of the anesthetic.
我明天要去看我叔叔|I am seeing my uncle tomorrow.
什麼樣的人會將種族滅絕者稱之為“英雄”|What kind of person looks up to a genocidal killer and calls him a hero?
他的实验用了鸽子|He used pigeons in his experiment.
你打过鼾吗|Have you ever snored?
他一如往常沒有剃鬍子就上班去了|As is often the case with him, he went to the office without shaving.
王小明还没有去过美国,他很想明年去.|Xiaoming Wang has never been to America. He really wants to go next year.
我現在上班無法離開|I can't get away from work now.
這東西怎麼吃啊|How does one eat this?
他面有飢色|He had a hungry look.
我不知道他今晚會不會來|I wonder if he'll come tonight.
城市位于日本的最北端|The city is at the northern end of Japan.
我应该知道|I should know.
主场队总是比对手有优势|The home team always have an advantage over their opponents.
我永远记得那件事|I'll always remember that.
工厂的废料导致了严重的环境污染|The factory waste gave rise to serious environmental pollution.
有一家便利店在马路斜对面|There's a convenience store diagonally across the street.
今年的天气不太正常|This year's weather is rather unusual.
不知道第三次世界大战会不会爆发|I wonder if a third world war will break out.
不要以穿著來判斷一個人|Don't judge a man by his clothes.
你几个用户名呀|How many accounts do you have?
我吃了五個牛油果|I ate five avocados.
不要害怕意外但要有準備|Do not fear the unexpected, but be prepared for it.
你游泳游得比我好|You swim better than I do.
他10年中第一次访问他的故乡|He visited his hometown for the first time in ten years.
你給你父母看了嗎|Did you show it to your parents?
我也这么认为|I think so too.
每一个函数都应该有描述其目的的注释以避免误解|Every function should have comments describing its purpose in order to avoid confusion.
那是一個仿造品|That's an imitation.
我們叫我們的狗Johnnie|We call our dog Johnnie.
他一點禮貌也沒有|He has no manners at all.
沒有人會知道|Nobody will know.
我们发现他是她的父亲|We found out that he was her father.
你看起来和以前一样健康|You look as healthy as ever.
小心在那裡有一個大洞|Watch out! There's a big hole there.
爸爸昨天帶了我們去動物園|Father took us to the zoo yesterday.
总会在九点整开始了|The general meeting began at 9 am on the dot.
你为什么那么高兴|Why are you so happy?
我不喜歡大狗|I don't like big dogs.
树叶变红了|The leaves of the trees have turned red.
不要这样对我讲话|Don't talk to me like that.
我為他提供了食物|I provided him with food.
湯姆住在我的附近|Tom lives near me.
他身肩重任|A great responsibility lies on his shoulders.
告诉我们你的想法|Tell us your thoughts.
我认为汤姆将迟到|I think that Tom will be late.
你為什麼學廣東話|Why are you learning Cantonese?
緊急出口在哪裏|Where's the emergency exit?
你的理由很充分|Your reason is very good.
請讓我們分開付錢|Please bill us separately.
他們相信死後的生命|They believe in a life after death.
我聽湯姆說話聽得煩|I'm tired of listening to Tom.
真是美好的一天|This is a great day.
我们的老师会给我们出难题|Our teacher will give us difficult problems.
如果你和Tom呆在一起结果会更好|It would've been better if you'd stayed with Tom.
你要吃麵條還是吃米飯|Do you want to eat noodles or rice?
我一点咖啡也不喝|I don't drink coffee at all.
她每天早上都會喝一瓶牛奶|She has a bottle of milk every morning.
上個星期這架飛機墜毀了|The plane crash was only last week.
你见到今天早上的彩虹了吗|Did you see the rainbow this morning?
请保密|Keep it secret, please.
我昨晚跟他通电话了|I talked to him on the telephone yesterday night.
你甚麼看法呢|What's your opinion?
媽媽帶我去公園|My mother took me to the park.
她周遊世界各地|She traveled around the world.
如用現金付款我們給予九折優惠|We give a 10% discount for cash.
她的皮肤比雪还白|Her skin is more white than snow.
不好意思|Sorry?
你可以把音量調低一點嗎|Could you turn down the volume?
我在国外指派了|I was abroad on an assignment.
我欠他一百元|I owe him $100.
這幫不了你|This won't help you.
耐心不是我的强项|Patience is not my forte.
你是今天買還是昨天買的|Did you buy it today or yesterday?
大多数学生步行去学校|Most students walk to school.
请跟我来跟我们来|Come with me, come with us!
我們不傻|We're not stupid.
你九点上班|You start working at nine.
她只是個孩子|She is no more than a child.
這是一個非常複雜的問題|This is a very complex problem.
我是人类学的研究学生课题是“中医在英国”|I'm an anthropology research student, and my topic is 'Chinese medicine in Britain'.
那个我认为会通过考试的朋友失败了|The friend who I thought would pass the exam failed it.
汤姆多才多艺|Tom has many talents.
請勿給野生動物餵食|Please don't feed the wild animals.
這污點擦不掉|This blot can't be wiped out.
原来如此|So that's what it is.
您运气多好啊|How lucky you are!
我沒聽到任何人在說話|I didn't hear anybody talking.
汤姆既彬彬有礼又善解人意|Tom is polite and sensitive.
下雨也沒關係我還是可以去|It's raining but never mind, I can still go.
湯姆有等我們|Tom waited for us.
就我所知铃木先生还没从夏威夷回来|Mr Suzuki, as far as I know, has not returned from Hawaii yet.
这次大选创造了多项第一也诞生了很多将世代流传的故事但是今天晚上令我难忘的却是在亚特兰大投票的一名妇女安-尼克松-库波尔她和其他数百万排队等待投票的选民没有什么差别除了一点她已是106岁的高龄|This election had many firsts and many stories that will be told for generations. But one that's on my mind tonight is about a woman who cast her ballot in Atlanta. She's a lot like the millions of others who stood in line to make their voice heard in this election, except for one thing: Ann Nixon Cooper is 106 years old.
我把我自己用力拉起來|I heaved myself up.
当然祝你好运|Sure. Good luck!
我怎麼沒早點想到|Why didn't I think of that earlier?
我買了一支手錶給她|I bought her a watch.
这真是一个很善良的愿望|This is a really kind wish.
詩人對他愛的女人表達了他火熱的激情|The poet expressed his burning passion for the woman he loved.
你们可以搜索含有某个词的句子并得到这些句子的翻译|You can search sentences containing a certain word and get translations for these sentences.
严格来说中文包含几百种方言|Strictly speaking, Chinese consists of hundreds of dialects.
他們現在有三個小孩|They have three children now.
我猜想你饿了|I suppose you're hungry.
他讀了一本用英文寫的書|He read a book written in English.
美国是世界最大的经济体并拥有最强的军队|America has the world’s largest economy, and its army is the most powerful.
他成为了著名的歌手|He became a famous singer.
我希望可以更紧张我的成绩但是似乎在我生命的某一刻我决定它将不再那么重要了|I wish I could care more about my grades but it seems that, at a certain point of my life, I decided they wouldn't be so important anymore.
请联系我们|Please contact us.
春天來了|Spring has come around.
我相信這種藥對你的病情有幫助|I believe this type of medicine will help your illness.
我自有分寸|I know what I'm doing.
這間酒店的交通位置很方便|This hotel is conveniently located in terms of public transportation.
我很喜歡奈良尤其在秋季的時候|I love Nara, especially in autumn.
湯姆希望瑪麗別死|Tom hoped that Mary wouldn't die.
最重要的是你要好好照顧自己|Above all, you must take good care of yourself.
我两个脸颊都被打了|I got slapped on both cheeks.
一个拄着拐杖的年轻女孩问汤姆他住在哪里|A young girl on crutches asked Tom where he lived.
狐狸是野生动物|A fox is a wild animal.
她盡了自己的職責|She performed her duties.
每次我去日本餐馆我都会把筷子带回家|Every time I go to a Japanese restaurant, I bring the chopsticks home.
昨天你没有去学校|You were absent from school yesterday.
他岁数和你差不多|He's about the same age as you.
他不仅是对这个有兴趣并相当热衷|He is not just interested, he's crazy about it.
现在谈这件事还为时过早|It's still too early to talk about this now.
他總是缺錢|He's always running short of cash.
您已經投了票了嗎|Did you vote yet?
不要忘了關燈|Don't forget to turn the light off.
爸爸告訴了我要洗車|Father told me to wash the car.
天快要下雨了|It's going to rain.
约翰组装了书架|John built a bookcase.
汤姆看起来的确比玛丽年轻|Tom definitely looks younger than Mary.
我绝不能原谅她|I can under no circumstances forgive her.
但我将总是会向你们坦陈我们所面临的挑战我会听取你们的意见尤其是存在不同意见的时候最重要的是我会请求你们参与重建这个国家以美国221年来从未改变的唯一方式-一砖一瓦同心协力|But I will always be honest with you about the challenges we face. I will listen to you, especially when we disagree. And above all, I will ask you to join in the work of remaking this nation, the only way it's been done in America for 221 years; block by block, brick by brick, calloused hand by calloused hand.
马里是在撒哈拉以南非洲最贫穷的国家之一|Mali is one of the poorest countries in Subsaharan Africa.
讲到埃及就想到了尼罗河|We associate Egypt with the Nile.
湯姆不是箇善人|Tom is not a friendly guy.
他没疯|He isn't crazy.
這本書真的很有趣|This book is really interesting.
我们还有很多时间|We still have plenty of time.
你在思考無關緊要的事情|You're thinking of unimportant things.
她成功地開車了|She managed to drive a car.
你为什么工作|Why do you work?
我來這裏已有十年了|It has been ten years since I came here.
我的牙很痛|I have a toothache.
他能讲流利的日语|He's fluent in Japanese.
江山易改本性难移|A leopard never changes its spots.
我什么都不是|I am nothing.
這架飛機飛越了這座山|The plane flew over the mountain.
我不知道你怎么样但我饥肠辘辘|I don't know about you, but I'm starving.
她怕過馬路|She was afraid to cross the road.
她天生体弱|She is weak by nature.
合同已经到手了那就出去庆祝一下吧|The contract is in the bag, so let's go out and celebrate.
我喜歡明亮的顏色|I like bright colours.
我親了她的額頭|I kissed her on her forehead.
你只給了我五十美分|You only gave me fifty cents.
您十一点时来看我吧|Come and see me at eleven o'clock.
UN代表聯合國|UN stands for the United Nations.
他看起来很年轻|He looks young.
这艘船没有雷达装备|The ship is not equipped with radar.
你的演說十分精彩但竟沒人懂得欣賞|Your wonderful lecture was pearls before swine.
他也会说俄语|He can speak Russian as well.
一頭熊攻擊了湯姆|A bear attacked Tom.
我似乎不太喜欢小米我觉得小米是屌丝用的手机就是个山寨机|I don't really like Xiaomi phones, and I think that they're for losers. They're like knock-offs.
汤姆说他不想把时间浪费在争论上|Tom said he didn't want to waste time arguing.
太贵了|Too expensive!
他們在加拿大說法語嗎|Do they speak French in Canada?
难怪我们没有办法说话|No wonder we could not speak.
抱歉我不會說葡萄牙文|I'm sorry, I don't speak Portuguese.
這本是上個禮拜銷量最高的書|This was the best-selling book last week.
你买了往返的票吗|Did you buy a round-trip ticket?
他悄悄地递给我一张纸条|He slipped me a note.
你覺得這兒發生了什麼呢|What do you think happened here?
你自投罗网了|You've walked into a trap.
现场有10名警员|There were ten police officers on the spot.
凱倫在跳蚤市場買了很多東西|Karen bought a lot of things at the flea market.
这个城市人口众多|The city has a large population.
如果没鱼了您会说什么|What would you say if there weren't any more fish?
當時包柏在洗碗|Bob was washing the dishes at that time.
裁判抛硬币来决定谁来开球|The coin toss decides who will kick off the match.
你能在我的背上涂些防晒霜吗|Can you put some suntan lotion on my back?
我剛吃完了早飯|I've just finished breakfast.
你有卖这种钱包吗|Do you sell this type of wallets?
出门前记得检查一下煤气是否关好了|Remember to check to make sure the gas has been turned off before you go out.
能再告诉我一点吗|Can you tell us a bit more about that?
費歐娜的來信漸漸減少了|Fiona's letters gradually came less and less.
好车|Nice car!
他是一位小說家和詩人|He is a novelist and a poet.
这个旅馆的房间不像那个旅馆的房间那么干净|The rooms in this hotel are not as clean as the rooms in that hotel.
他总喝他的黑咖啡|He always drinks black coffee.
當聽到這個消息她看起來高興|She looks happy on hearing the news.
兩個句子是一致的|The two sentences are both coherent.
我们租了公寓|We rented an apartment.
你想要的是最重要的|What you want is the most important thing.
我正在读汉字|I am pronouncing Chinese words.
如果我錯了請你指正|Correct me if I am wrong.
这个漂亮女孩在床上|The beautiful girl is in bed.
丽萨不但会说英文而且会说法文|Lisa speaks not only English but also French.
我信鬼神之说|I do believe in ghosts.
情況比我想的還壞|The situation is worse than I thought.
你常见到她吗|Do you see her often?
你是安娜嗎|Are you Anna?
我只是希望我们能离开这个可怕的地方|I just wish we could leave this horrible place.
Pierre电脑里有很多盗版软件|Pierre has a lot of pirated software on his computer.
他们一起旅游|They traveled together.
悉尼的空气比东京的要干净|The air of Sydney is cleaner than that of Tokyo.
他從東京飛到了大阪|He went from Tokyo to Osaka by plane.
我想再去那裡一次|I want to go there once more.
他非常喜歡音樂|He likes music very much.
我曾经每周末都和朋友外出|I used to go out with friends every weekend.
嚴格地說你錯了|Strictly speaking, you are wrong.
别笑|Don't laugh!
好險好險|That was dangerous!
我想下个月和一个朋友去北海道|I want to go with a friend to Hokkaido next month.
他就是我們一直要找的那一個人|He is the very man that we've been looking for.
人是从语言里学会语法而非从语法里学会语言的|One learns grammar from language, not language from grammar.
她喜歡喝酒|She likes to drink.
他们都像这一样吗|Are they all like this?
不知道那看起來怎樣|I don't know what that looks like.
神戶是著名的港口|Kobe is famous for its port.
我不想再见到他们|I didn't want to see them again.
阿尔及尔有自行车道吗|Are there any bike lanes in Algiers?
我们7点吃了早饭|We ate breakfast at seven.
你有义务还债|You're liable for the debt.
我吃了你的草莓|I ate your strawberries.
我本應該先問的|I should've asked.
你了解它吗|Do you know it?
她的祖母活到了88岁|Her grandmother lived to be 88 years old.
多少錢|What's the price?
他為自己的孩子能做的都做了|He did everything he could for his child.
要想学好中文 就应该多跟中国人交流.|If you want to study Chinese well, you should communicate with Chinese people more often.
他昨天去世了|He deceased yesterday.
玛丽有一百多双鞋|Mary has more than a hundred pairs of shoes.
因为它太大了|It's because it's too big.
"侏儒流氓"是德國導演韋納荷索在一九七零年的一部電影|Even Dwarfs Started Small is a 1970 film by German director Werner Herzog.
他很高兴|He's happy.
她爱他他爱她|She loved him and he loved her.
它正是我所期待的|It's just what I expected.
我不能收这份礼|I can't accept this gift.
感謝你的付出|Thanks for everything.
有人救了我的命|Someone saved my life.
系上您的安全带|Fasten your seat belt.
你好吗|How're you doing?
你爱拿多少就拿多少|Take as much as you like.
首都天气有雨|The weather in the capital is rainy.
茱莉的哥哥從意大利寄了一張聖誕賀卡給她|Julie received a Christmas card from her brother in Italy.
他有点喝醉了|He's a little bit drunk.
听天气预报说今晚有雨|The weather forecast said tonight it will rain.
这么晚|This late?
不要在背后说人坏话|Don't speak ill of others behind their back.
他给谁打的电话|Who was it that he phoned?
你是一個笨蛋|You're an idiot.
昨夜我烂醉了我没洗澡就睡觉了|Last night I was dead drunk and fell asleep without having a bath.
市场上涨了半点|The market rose half a point.
你怎么了|What's with you?
他们正在读一本书|They're reading a book.
你喜歡煮日本料理嗎?|Do you like to cook Japanese foods?
只有一家商店卖这本书|One can acquire this book in one store only.
說得簡單|Speaking is easy.
我是护士|I am a nurse.
勞拉英戈爾斯是在草原上長大的|Laura Ingalls grew up on the prairie.
这很容易啊|This is easy!
他把一個包裹挾在腋下|He held a package under his arm.
他邊顫抖邊說那座城堡有鬼|"The castle is haunted," he said with a shiver.
我的錢包不見了|My wallet's gone.
我是护士|I'm a nurse.
她希望成為一名設計師|She hopes to become a designer.
每个阿尔及尼亚的男性市民都需要服兵役|Every male Algerian citizen must do military service.
大家都在瞪着|People were staring at us.
桌上的计算器是我的|The calculator on the table is mine.
他热泪盈眶|His eyes were brimming over with tears.
你绝对肯定吗|Are you absolutely sure?
安娜和何塞是同學|Anna and Hesai are classmates.
上個月我在倫敦|I was in London last month.
啊我认识这个男人|Oh! I know this man!
大卫在家|David is at home.
我相信知识就是力量|It's my belief that knowledge is power.
他用手遮住眼睛|He covered his eyes with one hand.
我喜欢游泳但我不想在这里游|I like swimming, but I don't like to swim here.
我想买一双滑雪靴|I want to buy a pair of ski boots.
在苏联句子写你|In Soviet Russia, sentence writes you!
她不總是高興|She is not always happy.
我该带些什么|What should I bring?
我只想跟汤姆说话|I just wanted to speak to Tom.
他下个月会去纽约|He will go to New York next month.
永远不要忘记把门锁上|Never forget to lock the door.
是阿里斯特杀了芭芭拉|It was Alister who killed Barbara.
他们非常喜欢那首歌曲|They love that song.
坐這個公車可以到球場|You can go to the ballpark on this bus.
我深深地被她的仁慈所感動|I was very moved by her kindness.
Wienczysława是這個工作場所裡最美麗的黑髮女人|Wienczysława is the most beautiful brunette in the workplace.
我不再愛湯姆了|I no longer love Tom.
自己生了孩子後才明白母愛到底是怎麼一回事|It was not until I had a baby myself that I knew what mother's love is.
他的人品出众|He's a man of outstanding character.
从大阪到秋田的车费是多少|What is the fare from Osaka to Akita?
我打算存更多錢|I'm going to save more money.
吃药之前一定要仔细看说明书|When taking drugs, follow the directions on the bottle carefully.
我们班至少有三十个学生|There are at least thirty students in our class.
这把椅子是塑料做的|This chair is made of plastic.
这篇英语作文离完美还差得远|This English essay is far from perfect.
我已經打掃完我的房間了|I've finished cleaning my room.
这列火车时速20英里|The train makes 20 miles an hour.
我哥住在一座小村庄里|My brother lives in a small village.
我会说中文|I speak Chinese.
你能不能给我打折|Can you give me a discount?
现在已经九点多了|It's already past nine o'clock.
汤姆不是唯一安排呆的人|Tom isn't the only one who plans to stay.
她做了一套新衣服給他|She made a new suit for him.
双方本周举行会谈|The two sides hold talks this week.
我们值得拥有|Because we're worth it.
謝謝你接受我Facebook的交友邀請|Thanks for accepting my friend request on Facebook.
今天是星期六|Today is Saturday.
我快被笑死了|I almost died laughing!
你有登山靴嗎|Do you have hiking boots?
那很可笑|That will be funny.
这只是个假设|This is just a hypothesis.
只有一些人了解我|Only a few people understood me.
我還記得很多年前有一次我在溫哥華的市中心過馬路一個印第安女人看著我說道別笑我能從她的臉上看出異域的西方文化真的框住了她的生活|Walking through the crosswalk in Downtown Vancouver, BC, many years ago, a Native Indian woman looked at my face and said, "Don't smile!" I could see on her face how foreign Occidental culture really strained her life.
如何提高工作效率是我们现在要面临的难题|The challenge we are going to face is how to increase work efficiency.
能够出一份力太好了|I'm glad I could help.
这家酒店有免费的Wi-fi|This hotel has free Wi-Fi.
很多人都會問為什麼生肖的十二種動物裡沒有貓呢|A lot of people ask why the cat does not appear among the twelve animals of the Chinese zodiac.
我感覺到我的手在震動|I felt my hands tremble.
多少錢|How much is this?
你认为我们会遇到好天气吗|Do you think we'll have good weather?
我今天下午會很忙|I will be busy this afternoon.
沒有必要這麼生氣|There's no need to get so angry.
汤姆说他不确定玛丽想做什么|Tom said he wasn't sure what Mary wanted to do.
我应该知道|I should know that.
所有事都取決於你的決定|Everything depends upon your decision.
下午我必须为旅行做准备了|In the afternoon I must arrange for the trip.
我明年17岁|I'll be seventeen next year.
這個點球的判罰正確嗎|Is the incurrence of this penalty correct?
楼下有人在等您|Someone is waiting for you downstairs.
我自己也因違例泊車而被罰了許多次款|I've paid parking fines a number of times myself.
看缘分吧|Let's see what fate has prescribed.
這一定是假的|These must be fake.
他喜歡一切甜的東西|He likes anything sweet.
千万别误会我的意思|Please don't mistake my meaning.
約翰和蘇最後決定把蘋果切成兩半|At last, John and Sue decided to cut the apple into halves.
你在生汤姆的气吗|Are you mad at Tom?
汤姆和玛丽都死了|Both Tom and Mary died.
这个磁带录音机不是新的|This tape recorder is not new.
他的所有句子都很短|All his sentences are short.
我女儿想要架钢琴|My daughter wants a piano.
你是认真的吗|Are you for real?
旗子升起了|The flag is up.
請立刻回來|Please come back at once.
”哈亚斯坦“是亚美尼亚的名字在亚美尼亚语中|'Hayastan' is Armenia's name in Armenian.
他很聰明但卻不太幫得上忙|He may be clever, but he is not very helpful.
Bárbara被Alister所殺|Barbara was killed by Alister.
你想我吗|Do you miss me?
我已經告訴過你了|I have told you already.
一群人聚集在现场|A crowd gathered at the scene.
你应该是去睡得很晚|You must've stayed up late.
你喜欢牛奶还是咖啡?|Would you prefer milk or coffee?
Tom是我哥哥|Tom is my older brother.
他半夜打电话给我|He gave me a ring at midnight.
我在亞平寧山脈看到了狼|I saw wolves in the Appennines.
走過兩個街區然後左轉|Walk two blocks, and turn left.
你能幫我買些東西嗎|Can you do some shopping for me?
他讓我等了整整一上午|He kept me waiting all morning.
他的看法似乎太樂觀了|His view seems to be too optimistic.
我下一站下车|I'll get off at the next station.
她大約跟我同年紀|She's about the same age as I am.
月亮已從地平線升起了|The moon was above the horizon.
錯在哪裡|Where was the mistake?
谁在听|Who's listening?
他已经走了|He had already gone.
我要怎麼停用我在這個網站上的帳戶|How can I deactivate my account on this site?
聚會結束了嗎|Is the party over?
我就是在給我女友寫信|I'm just writing a letter to my girlfriend.
我是女人|I'm a woman.
我更喜歡用手寫信|I still prefer to write letters by hand.
我上了当还以为他们的玩笑是真的呢|I was played, I thought their joke was real!
我可以在一週內做|I can do it in a week.
我没任何零钱|I don't have any change.
你恨湯姆不是麼|You hate Tom, don't you?
他信守了他的承诺|He kept his promise.
湯姆並不信任警察|Tom doesn't trust the police.
我直接地問了他|I asked him point-blank.
我回到家的时候感觉非常饿|When I got home, I was very hungry.
你爲什麽生我的氣|Why are you angry at me?
水泥會在數個小時內凝固|The cement will set in a couple of hours.
她是在为其担心她会发胖的饮食|She is on a diet for fear that she will put on weight.
湯姆每次去波士頓都去看瑪麗|Tom visits Mary every time he goes to Boston.
我想住在城市|I want to live in the city.
你很怪- 我喜歡你|You're weird - I like you.
那個旅行很貴|That trip is expensive.
我和她約了今晚八點半在大教堂見|I met her at 8:30p.m at the cathedral.
你很健谈不是吗|You're very talkative, aren't you?
城市安睡了|The town slept.
她不在|She is absent.
男人跟隨了他|The men followed him.
我在前往會議的路上|I'm on my way to the meeting right now.
你最近去哪裡旅遊了嗎|Have you traveled anywhere recently?
我叫汤姆你呢|My name's Tom, and you?
我對我做過的事不後悔|I have no regrets about what I did.
本地人外来人齐心共创上海新文明|Native Chinese people are working alongside foreigners to change the culture of Shanghai.
在日本有站長是貓的車站|There's a train station in Japan where the station master is a cat.
我會借給你我的課本|I'll lend you my textbook.
这就是那个作家自杀的房间|This is the room where the author killed himself.
我們很快就可以知道事情的真相了|It will not be long before we can know the truth of the matter.
回答我的問題|Answer my questions.
她在街上看到我也不跟我打招呼|She ignored me even when she met me on the street.
谁写了这个故事|Who wrote this story?
我知道汤姆知道我应该这样做|I know Tom knows that I should do that.
美國的司法制度是世界上最好的|The legal system in America is the world's finest.
她們不是敵人而是朋友|They are not enemies, but friends.
我把雨傘落在這裡了嗎|Did I leave my umbrella here?
她真是让我莫不着头脑|I couldn't make her out at all.
屋顶上有只白鸽|There's a white dove on the roof.
不要这样看我|I don't want that kind of look from you.
貝克小姐知道那個年輕男子很快就要離開了所以決定請求他將車稍微移開如此一來她就能在夜間入睡前將她的車停到正確的位置|Miss Baker knew that the young man would have to leave very soon, so she decided to ask him to move his car a bit, so that she could park hers in the proper place for the night before going to bed.
我需要做手术吗|Do I need surgery?
樹下有一些男孩|There are some boys under the tree.
我累得走不動了|I'm too tired to walk any further.
这块蛋糕很甜|This cake is very sweet.
我想念波士頓|I miss Boston.
不要在這裏跑來跑去|Don't run here.
從這兒到澳大利亞大既要幾小時呀|About how many hours does it take to get from here to Australia?
我要回家|I want to go home.
哈利今年才四十歲|Harry is only 40.
你昨天上午打了网球吗|Did you play tennis yesterday morning?
這是我現在的住址|This is my current address.
托馬斯買了幾個避孕套|Tom bought some condoms.
汤姆不肯和我说话|Tom refused to talk to me.
我們要以史為鑒|We should learn from history.
我十一點鐘的時候在等你|I expected you at 11 o'clock.
除了那些我们尝试过的政府形态民主是最差的那种了|Democracy is the worst form of government, except all the others that have been tried.
你不喜歡愛情故事是嗎|You don't like love stories, do you?
梦虽然不会告诉你现实中将要发生什么却能告诉你内心的真实想法|While dreams cannot tell you what will happen to you in reality, they are able to convey your innermost thoughts.
斯宾诺莎是泛神论者|Spinoza was a pantheist.
凱特知道如何做蛋糕|Kate knows how to make a cake.
你們一天提供幾班飛往紐約的航班|How many flights to New York do you offer a day?
我昨晚做了一個關於你的夢|I had a dream about you last night.
沒人知道她的名字|Nobody knows her name.
他走后我们都很想念他|We've really been missing him since he left.
处理玛丽的健康问题对汤姆来说不容易|It hasn't been easy for Tom to deal with Mary's health problems.
在这么嘈杂的环境中无法学习|One cannot study in such noise.
一支大军正浩浩荡荡地行进着|A large army is proudly proceeding.
我沒做什麼與眾不同的事|I did nothing out of the ordinary.
我需要些建议|I need advice.
访客通常在进入一户日本人家之前会被要求脱鞋|At the entrance of a Japanese house, visitors are generally asked to take off their shoes.
你要是不答应的话我就袖手旁观|If you don't make the promise, then I'll just stand by and watch.
你有车吗|Have you got a car?
不是真的|It's not true!
這是什麼聲音|What's this noise?
是关门的时候了|It is time to shut the gate.
我找不到我的錢包了|I can't find my wallet.
请再给我一些水|I'd like some more water.
Dan對他的夥伴說謊|Dan lied to his associates.
今天的報紙說城裏發生了火災|According to today's paper, there was a fire in the city.
一只狐狸不会两次掉入同一个陷阱里|A fox is not caught twice in the same snare.
一切都还顺利吧|Everything's still going well?
打扰了这个多少钱|Excuse me, how much does this cost?
他告诉我她生病了|He told me that she was sick.
湯姆戴假髮|Tom wears a wig.
他晚回来了两天|He came back two days late.
結果並不可觀|It was a modest outcome.
我們一整晚都待在那裡|We stayed there the whole night.
汤姆有一辆灰色的车|Tom has a gray car.
黑人不得不坐在公交车的后面如果后面的座位满了则只能站在那里|Black people had to sit in the back of the bus, or stand if the back was full.
人生就像騎單車一樣要保持平衡就得不停地前進|Life is like riding a bicycle. To keep your balance you must keep moving.
我的护照被人偷了|My passport was stolen.
你觉得我是个酷哥吗|Do you think of me as a cool guy?
这很简单|It is very simple.
她違背了她父親的意願結了婚|She got married in defiance of her father.
汤姆是个好厨师|Tom is a good cook.
你知道怎么做吗|Do you know how to do this?
警察告诉我巴士的末班车在十点出发|The policeman told me that the last bus leaves at ten.
我的牙齦流血|My gums bleed.
你们什么时候开始学英语的|When did you begin learning English?
你就是做那事的人嗎|Are you the one who did that?
你们会讲加泰罗尼亚语吗|Do you speak Catalan?
湯姆不知道如何跳舞|Tom doesn't know how to dance.
她假裝生病了|She pretended that she was sick.
宇宙裡有多少個星系呀|How many galaxies are there in the universe?
你應該戒菸|You should give up smoking.
他一年來東京一次|He comes to Tokyo once a year.
你真冷酷無情|You have no heart.
他們將在兩天內拆除這棟舊的建築物|They will tear down the old building in two days.
你的考试通过了吗|Did you pass your exams?
你在哪儿学习|Where do you study?
據說火星上是沒有生物的|It is said that there is no life on Mars.
每一个人都应该知法懂法但是真正能做到的人却很少|Everybody is supposed to know the law, but few people really do.
我有一本剪报夹|I have a newspaper clipping file.
Einstein认为自己是一个哲学家|Einstein regarded himself as a philosopher.
人们趋向于带着偏见看待他人|People tend to look at others with bias.
你昨晚送她回家了嗎|Did you drive her home last night?
汤姆是我认识的人当中游泳最快的|Tom can swim faster than anyone else I know.
苦盡甘来|No pain, no gain.
汤姆不必知道我要去哪|Tom doesn't need to know where I'm going.
你們全都過來|Come here, all of you.
我會給你們看些照片|I will show you some pictures.
艾尔肯也喜欢她|Erkin likes her too.
下週六早上我要去芝加哥|I'm leaving for Chicago next Saturday morning.
我们没有失望|We have not lost hope.
休息结束了|The break is over.
我想知道汤姆还要别的什么|I wonder what else Tom wants.
四乘以二等於八|Four multiplied by two is eight.
這條隧道是那條的兩倍長|This tunnel is twice as long as that one.
我无法区分青蛙和蟾蜍|I can't tell a frog from a toad.
我打算去那裡|I plan on going there.
这表明它们注意听了顾客的需要|This shows they have listened to the needs of their clients.
汤姆没有微波炉|Tom doesn't have a microwave oven.
鲍勃忘记带通行证这使得他上学迟到了|Bob forgot to bring the pass, which made him late for school.
孩子在这条河里游泳太危险了|This river is dangerous for children to swim in.
工作困難嗎|Is the work hard?
好险啊|That was a close one.
我今天晚上離開東京到大阪|This evening, I am leaving Tokyo for Osaka.
湯姆是我見過的最無趣的人之一|Tom is one of the most boring people I've ever met.
他很高興聽到這個消息|He is glad to hear the news.
我完全不负任何责任|I don't take any responsibility at all.
他發生了什麼事|What happened to him?
不是所有的鸟都会飞|Not all birds can fly.
子瑞在思考|Ziri was thinking.
今天下雪|It's snowing today.
我得了什麼病|What disease do I have?
他没违法|He's not breaking the law.
你們呢|And you?
没有什么是神圣的|Nothing is holy.
邁克這是你的書嗎|Is this your book, Mike?
如果你需要我的建议我很愿意告诉你|If you need my advice, I'd be glad to give it to you.
有人在意吗|Does anyone care?
你說的話沒有道理|What you're saying makes no sense.
當我在我母親的子宮裡, 我從我母親的肚臍看到我將要出生的房子, 我心想: 我不要到那裡"|When I was inside my mother's womb, I looked through my mother's navel at the house where I would be born and I thought: "No way I'm going there".
他滑雪时摔断了腿|He broke his leg skiing.
你昨天早上在打网球吗|Were you playing tennis yesterday morning?
這份工作錄取仍然有效|The job offer still stands.
房間裡幾乎沒有人|There was hardly anyone in the room.
给汤姆打过电话了吗|Did you call Tom?
你會開手排車嗎?|Can you drive a manual transmission?
這可能是一場婚禮|It might be a wedding.
我們有充足的時間|We've got plenty of time.
CNN纪录片当中探究皇室最新成员在适应的时候他们是如何支持她的|In the documentary, CNN explores how the royal family has supported their latest member as she finds her feet.
我們下週六將去野餐|We're going on a picnic Saturday week.
湯姆想跟瑪麗好只是爲了錢|Tom wants Mary only for the money.
原諒別人就是善待自己|To forgive others is an act of kindness to yourself.
麥克每天大概賺三百元|Mike makes about 300 yuan a day.
我很抱歉用这种方式把你请来|I apologize for the methods used to get you here.
您会使用计算机吗|Can you use a computer?
说谎不好|It is not good to tell a lie.
你星期幾學漢語|Which day do you learn Chinese?
肯一直在找你|Ken has been looking for you.
他再次被选为市长|He was elected mayor again.
演员们一边唱一边跳表演得好极了|The performers danced whilst singing - they performed extremely well.
一个成长中的孩子如果没有充足的能量可能需要药物治疗|A growing child who doesn't seem to have much energy perhaps needs medical attention.
汤姆说不行会怎样呢|What if Tom says no?
我洗了澡|I've had a bath.
他在这儿住了有一段时间了|He lived here for a time.
我恐高|I'm afraid of heights.
他的英语很好|He speaks English well.
你跟你的老板说什么了|What did you tell your boss?
大名是什么|What is his real name?
你确定你没见过他吗|Are you sure you've never met him?
我們在一家小咖啡店吃了午飯|We had lunch at a little coffee shop.
汤姆告诉我他父亲去世了|Tom told me his father had passed away.
Tom 不想让Mary走|Tom doesn't want to let Mary go.
不對|That's not right.
我可以为汤姆做|I can do that for Tom.
他的学习成绩很好|He has a good school record.
你能告诉我一点关于汤姆的事吗|Would you please tell me a little about Tom?
早餐时间在七点到九点|Breakfast is from seven to nine.
湯姆不可能比我年長|Tom can't be older than me.
她利用了我的无知|She took advantage of my ignorance.
她必須照顧她的母親|She has to look after her mother.
他的英文進步得很快|His English is improving very quickly.
女人观察男人思考|The woman observes and the man thinks.
没关系我来做|Don't worry. I'll do it.
快一點|Step on it!
这个科学家正在研究原子能|The scientist is working on atomic energy.
他老婆氣極了|His wife was hopping mad.
拿破崙率軍到俄羅斯|Napoleon led his troops to Russia.
我想親吻妳|I want to kiss you.
你的工作進行得怎麼樣|How is your work coming along?
你的床底下有什麼|What's under your bed?
無論妳的母親願不願意她遲早得接受她的女兒已成年這個事實|Whether your mother likes it or not, she will sooner or later have to accept the idea that her daughter has grown up.
我觉得你应该多休息一会儿|I think you should get more rest.
生命不长它是宽的|Life is not long, it is wide!
他們住在河對面|They live across the river.
我|Me.
您会待很久吗|Are you going to stay long?
今晚一定是好天|The weather will be good tonight for sure.
我缺钱|I'm short of cash.
你還想要什麼|What more do you want?
我還年輕|I am still young.
你不但不和我一起吃饭反而去和另一个女生吃饭|Not only did you not eat with me, you went to have dinner with another girl!
我不觉得电视会代替书籍|I don't think that television will take the place of books.
大约|Probably.
这个饮料的味道很明显是茶的味道|This drink clearly has the same flavor as tea.
日本在亚洲|Japan is in Asia.
只能在没有月亮的晚上见到地精|Kobolds can only be seen on moonless nights.
他們開車去車站|They went to the station by car.
他匆匆忙忙地出門不小心把鑰匙落在家裡|He hurried out the door, and accidentally forgot the key at home.
你和我都是這個學校的學生們|You and I are both students at this school.
他们呢|What about them?
她发现她已经断盐了|She discovered that she had run out of salt.
他妻子在灶旁做饭而他在坐着读书|He sat down and read while his wife was cooking by the fire.
她為了找新工作而來了東京|She came to Tokyo with a view to getting a new job.
這是你自己做的嗎?|Did you do this on your own?
下午请到我办公室来|Please come to my office in the afternoon.
我听到门关了|I heard the door close.
我们有一位非常好的厨师|We have a very good chef.
食堂開了嗎|Is the canteen open yet?
我忘了給他打電話|I forgot to call him.
村裏的每一個人都認識這位醫生|The doctor is known to everyone in the village.
亚妮是一位艺术家|Yanni is an artist.
徒手逮兔挺难|It is difficult to catch a rabbit by hand.
油是从橄榄中提炼出来的|Oil is extracted from olives.
等我做完那活儿就帮你|As soon as I've finished doing that, I'll help you.
他否認見過他|He denies having met him.
我回到家的時候爸爸媽媽都已經吃完飯了|My parents had already eaten by the time I got home.
我想吃點甜的東西|I feel like eating something sweet.
我们得保护汤姆|We need to protect Tom.
能说给我听你的地址吗|Can you tell me your address?
他們總是抱怨|They always complain.
愿力量与你同在|May the force be with you.
汤姆不知道玛丽住在哪里|Tom doesn't know where Mary lives.
大部分人都挺冷漠|The majority of people are quite indifferent.
自己可以做的事情他不喜欢去麻烦别人|He does things for himself. He doesn't like to bother other people.
汤姆交际广|Tom knows a lot of people.
我今天得把这本书还给图书馆|I have to return this book to the library today.
雖然二月電風扇的產量減少了但還是超過了一月|Although the production of electric fans was reduced in February, it still beats January.
数学是所有科学的基础|Mathematics are the foundation of all sciences.
人无法长生不死|It's not possible for humans to live forever.
我只有十本英语教科书|I've got just ten English textbooks.
這句話是什麼意思呀|What is the meaning of this sentence?
这个梯子是否足够坚固以承受我的重量|Is this ladder strong enough to bear my weight?
过来帮我们|Come and help us.
閉嘴|Zip up!
听说汤姆不会重蹈覆辙了|I hear Tom won't do that again.
我们在树林中迷路了|We got lost in the woods.
我晚点打给你|I will call you later.
第二天早上他就平安無事的回來了我們都大大的鬆了一口氣|The next morning, to our great relief, he returned home safe and sound.
我為你瘋狂|I'm crazy for you!
他侵犯了她的隐私|He intruded on her privacy.
还有什么想要的吗|Is there anything else you'd like?
沒有必要說話這麼大聲|There's no need to speak so loud.
俗話說一分耕耘一分收穫可俗話又說人無橫財不富馬無夜草不肥|As the saying goes, "You reap what you sow", and yet another says that luck plays an important role in success too!
我覺得我們應該再等等|I think we should wait a little longer.
我在這裡很長一段時間了|I've been here for a long time.
请你给我多一把叉子|Bring me another fork, please.
會議將於明天舉行|The meeting will be held tomorrow.
这电子辞典的好处就是便于携带|The good thing about this electronic dictionary is that it's easy to carry.
他看见色彩鲜艳的鸟花朵和树叶|He saw brightly-colored birds, flowers and leaves.
发泄很少改善我的情绪反而经常使它更糟|Venting rarely improves my mood and often makes it worse.
你现在在做什么|What are you doing right now?
我不知道這個蛋糕是誰做的|I don't know who made the cake.
覆水難收|There's no use crying over spilt milk.
我在晚上工作|I work during the night.
没有你的钥匙的话你还是进不去所以你不放来跟我们一起吃晚饭|You can't get in without your key anyway, so you may as well come to have supper with us.
每個人都應該做自己命運的主人|Everyone ought to be the master of his own destiny.
我們還有次機會|We still have a chance.
我好你更好她最好|I'm good, you're better, she's the best.
我知道我做错了|I know what I did was wrong.
我問了湯姆關於他的新書的事|I asked Tom about his new book.
這個土壤似乎長不出任何東西來|Nothing seems to grow in this soil.
你会说希伯来语吗|Do you speak Hebrew?
瑪麗很喜歡牛奶|Mary likes milk very much.
她在一棵树下坐着|She was sitting under a tree.
全面罷工癱瘓了整個國家|The general strike paralyzed the whole country.
你的理論並沒有科學根據|Your theory has no scientific basis.
“她有狗吗” “没有”|"Does she have a dog?" "No, she doesn't."
那條領帶很適合你的襯衫|That tie goes well with your shirt.
這個小女孩住在巴西|This little girl lives in Brazil.
请写信告诉我你们学校的情况|Please write to me about conditions at your school.
汤姆是在自家厨房里死的|Tom died in his kitchen.
我看到你開著你的新車|I saw you driving your new car.
對不起我太無理了|I'm sorry I was so rude.
我把身上的錢全都給了那個乞丐|I gave the beggar all the money I had.
你為誰工作|Who are you working for?
今天早上我接到她的一个电话|I got a call from her this morning.
我前天碰到了他|I met him the day before yesterday.
禁止越過白線|It is forbidden to cross the white line.
他虽然穷却很幸福|Even though he's poor, he's happy.
所以这就是Tatoeba|So that's Tatoeba.
她只是嫉妒你年轻|She's just jealous of your youth.
她打算离婚|She intends to get a divorce.
會議於下午4點結束|The meeting ended at 4:00 p.m.
你讨厌我吗|Do you hate me?
他真心喜欢我|He truly loves me.
那太多了吗|Was that too much?
你真的是汤姆吗|Are you really Tom?
“你怎么样”“我很好谢谢”|"How are you?" "I'm fine, thank you."
我叫路德维希|My name is Ludwig.
請讓我走|Please let me go.
湯姆從不坐電梯|Tom never takes the elevator.
虽然他是我的邻居但是我对他并不太了解|Even though he is my neighbour, I did not know him well.
动词变位很有趣的|Conjugation is interesting.
這班有五十個學生|The class consists of fifty students.
我們再給她們一次機會吧|Let's give them another chance.
我当时正忙着打包因为我两天后要去法国|I was busy packing, because I was leaving for France in two days.
嗨你怎么样|Hi, how are you?
她有幾百本書|She has hundreds of books.
我開玩笑的別當真|Don't take my jokes seriously.
英語是一種日耳曼語|English is a Germanic language.
老师不可能说过这样的事|The teacher cannot have said such a thing.
你会弹管风琴吗?|Can you play the organ?
随着年龄的增长他变得更加聪明|He became wiser as he grew older.
我的祖父死于二战|My grandfather died in the Second World War.
他很会教育人所以他的孩子都很听话|He's a very good teacher, so his children really listen to him.
你好汤姆|Hello, Tom.
太陽從海上升起了|The sun rose from the sea.
她終於受不了誘惑吃掉了整件蛋糕|Finally she gave in to temptation and ate the whole cake.
他的妻子是我的一個朋友|His wife's a friend of mine.
汤姆拍了这张照|Tom took this photo.
他也會說俄語|He can speak Russian, too.
差不多六点了|It's nearly six o'clock.
我們必須拔除雜草|We have to pull the weeds.
她有心臟病|She was ill with heart disease.
我们在芬兰|We are in Finland.
我準時到達了車站|I arrived at the station on time.
湯姆講法語講得還可以|Tom's French is OK.
我上週日花時間看了一本小說|I spent last Sunday reading a novel.
汽车发生故障了|The car broke down.
这样辉煌的成绩是如何取得的|How can one achieve such brilliant results?
她的花园是一件艺术作品|Her garden is a work of art.
您有打火机吗|Have you got a lighter?
我要另一片面包|I want another slice of bread.
物价上涨了|Prices are going up.
请把音乐声调小|Please turn down the music.
我可以問一些問題嗎?|May I ask some questions?
他已經決定了新的政策|He had decided on a new policy.
他准会忘|He's bound to forget.
我在1968年1月2日出生|I was born on January 2 in 1968.
如果沒有了音樂這個世界就會變得十分沉悶|Were it not for music, the world would be a dull place.
谢菲尔德星期三队在踢他们习惯的长传球|Sheffield Wednesday is playing their usual long-ball game.
把它吃掉|Eat up.
我向一個警察問路|I asked a policeman for directions.
她决定和他结婚|She decided to marry him.
您最喜欢哪个季节|What season do you like the best?
我不知道汤姆要被逮捕了|I didn't know that Tom was going to be arrested.
你是什麼時候買的|When did you buy it?
我知道原因但我不能告诉你|I know the reason, but I can't tell you.
汤姆说晚饭他会吃鱼|Tom said he was going to eat fish for dinner tonight.
你喝酒吗|Do you drink alcohol?
十分感谢|Thank you very much.
“你什么时候回来”“这都要看天气”|"When will you be back?" "It all depends on the weather."
下周再來|Come again next week.
我欣賞你的無知|I admire your ignorance.
一個墨西哥人教了他西班牙文|A Mexican taught him Spanish.
讓我們等一會兒看看你怎麼做|Let's wait for a while and see how you do.
为了更好地理解一家公司的文化你应该考虑下面的论点并看公司把它们怎么处理|To better understand what a company’s culture is you should consider the following points and see how the company deals with them.
你回来的时候我已经走了|When you returned, I had already left.
湯馬斯是以他父親的名字被命名的|Thomas was named after his father.
我星期日並不總是有空|I'm not always free on Sundays.
你在跟著我嗎|Are you following me?
在這附近當心小偷|Watch out for thieves around here.
她小時候唱歌唱得很好|She could sing well when she was a child.
我不知道有没有时间|I don't know whether I have time or not.
我突然想到你|I'm thinking about you.
我不欠债|I have no debt.
這是一支鉛筆|This is a pencil.
可能你应该放弃|Maybe you should just give up.
你在哪裡唸高中?|Where do you attend high school?
汤姆快跟上了不是吗|Tom is gaining on us, isn't he?
胡安他叫林峰我和林峰是朋友|Huan, he is called Linfeng, Linfeng and I are friends.
汤姆参加了当地的一个自行车比赛|Tom took part in a local bike race.
我们没怕|We weren't scared.
告诉我你为什么要去那儿|Tell me why you want to go there.
這座橋看起來很安全|This bridge looks secure.
我屏氣觀看眼前光景|I watched what was unfolding in front of my eyes with bated breath.
你能容忍他做事的方式么|Can you put up with the way he behaves?
汤姆拒绝帮玛丽做她的作业|Tom refused to help Mary do her homework.
波士顿现在几点|What time is it in Boston?
大家都說我是錯的|Everyone said that I was wrong.
你愿意来吗|Would you like to come?
他昨天到了东京|He arrived in Tokyo yesterday.
那天晚上你在哪裡|Where did you go that night?
你們公司幾點下班?|When do you close?
只有四匹馬參加了比賽|Only four horses were in the race.
你的穿著非常好|Your dress is very nice.
湯姆己經在那裡了|Tom is already there.
我能和湯姆講話嗎抱歉他剛走|"Can I speak to Tom, please?" "I'm sorry, he just left."
我衷心感谢您|I thank you with all my heart.
誰在影子裡藏著|What is lurking in the shadows?
我父母住在鄉下|My parents live in the country.
那不是傑克的錯|That's not Jack's fault.
因为我不是很饿所以我决定晚点吃|I wasn't very hungry, so I decided to eat later.
這是阿拉伯文嗎不是這是維吾爾文一種中國西北部的語言|"Is this Arabic?" "No, it's Uyghur - a language that's spoken in northwestern China."
很多人都會犯這個錯|Many people make that mistake.
我们玩点什么吧|Let's have some fun.
他看上去老但他还不到30岁|He looks old, but he hasn't reached 30 yet.
你是不是喝醉到能再说一遍德语的程度|Are you drunk enough to speak German once again?
1000日元够不够|Is a thousand yen enough?
我们谁也没看见|We haven't seen anyone.
他整天都在埋頭埋腦地看小說連飯也沒有吃|He has been absorbed in the novel all day without eating.
甚至是不相信天主教的人也把教皇敬为一个象征性的领导者|Even people who don't believe in the Catholic church venerate the Pope as a symbolic leader.
从那时起他的信仰开始摇动了|From the time he got up, his beliefs began to sway.
我在选择妻子时犯了一个很大的错误|I made a big mistake in choosing my wife.
别低估我|Don't underestimate me.
我喜歡這塊手錶|I like this wristwatch.
強森先生的房間是一個大房間|Mr. Johnson's room was a large room.
用於那個義大利醬的香草可能是荷蘭芹|The herb used in that pasta sauce might be parsley.
我不喜欢这个|I don't like this one.
汤姆和玛丽说他们今天下午打算和我们一起来打高尔夫|Tom and Mary say they intend to play golf with us this afternoon.
那个男人就是他的孩子很友好的那个.|That's the man whose kids are so nice.
永別|Gone forever.
他们的货品有着最高的品质|Their goods are of the highest quality.
要都解释的话需要一辈子的时间|It would take forever for me to explain everything.
有時間我就來|I will come, time permitting.
酒是灌入瓶中的诗|Wine is poetry in bottles.
周末愉快|Have a good weekend!
星星沒有被看到|Not a star was to be seen.
抓住他|Catch him!
我没懂你说什么|I don't understand what you are saying.
请在一米线外等候|Please wait one meter away.
我們走吧!|Let's go!
来的都是朋友|Whenever you come, you are welcome.
汤姆没有喜欢露营的朋友|Tom doesn't have any friends who like camping.
她的男朋友是个笨蛋|Her boyfriend is an idiot.
汤姆拼命地忍住笑声|Tom was trying hard not to laugh out loud.
在那裏放下來|Set it down there.
我希望他現在在這裡|I wish he were here now.
他也学习汉语|He studies Chinese too.
你可不年轻|You can't be young.
男孩到家了|The boy has come home.
你能解決這個問題呢嗎|Can you solve this problem?
疼痛令人难以忍受|The pain is unbearable.
他們的兒子被命名為愛德華|Their boy was named Edward.
我們遊遍全國各地|We traveled all over the country.
您有手机吗|Do you have a smartphone?
他是一個被稱為小約翰的大個子男人|He was a big man called Little John.
这个班有15个男生和28个女生|This class consists of 15 boys and 28 girls.
空调坏了|The air conditioner has got out of order.
信心毅力勇氣三者具備則天下沒有做不成的事|If confidence, determination and courage are together in one place, there is nothing that cannot be done.
請說更大聲一點|Please speak more loudly.
我們離上次見面有十年了|It's been ten years since we last met.
今天8.8级的强大地震袭击了日本的岛屿|A massive earthquake of magnitude 8.8 hit the Japanese islands today.
我們什麼時候可以吃|When can we eat?
湯姆把酒店訂單取消了|Tom canceled his hotel reservation.
我们处理掉了他们家的老鼠|We got rid of the mice in their house.
那頓飯簡直好極了|That meal was simply divine.
請用掛號寄這個|Please send this by registered mail.
如果班上有人過生日, 老師總是會在黑板上畫一面旗子|If someone in the class has a birthday, the teacher always draws a flag on the blackboard.
該建築高一百公尺|The building is one hundred meters high.
这是汤姆的东西吗|Does this belong to Tom?
还有两站下去|There are still two stops left.
我不知道该怎么办|I have no idea of what to do.
汤姆和玛丽娅对约翰说他们觉得埃尔克还没完成呢|Tom and Mary told John that they thought Alice wasn't done doing that.
他的演讲让我很无聊|His speech bored me.
就是這個答案讓那些長久以來被灌輸要嘲諷害怕和懷疑自身能力的人們 把他們的手放在歷史的弧線上將它彎向一個更美好的一天的希望|It's the answer that led those who've been told for so long, by so many, to be cynical and fearful and doubtful about what we can achieve, to put their hands on the arc of history and bend it once more toward the hope of a better day.
我搭电梯去了四楼|I took the elevator to the fourth floor.
她得知父親突然離世不禁心如刀割|She was filled with deep grief to hear of her father's sudden death.
你住在筱山多久了|How long have you lived in Sasayama?
你耳鸣吗|Do you have tinnitus?
在这种困难的时候任何寻常的努力都无法使我们的公司摆脱赤字|In hard times like this, no ordinary effort can get our company out of the red.
我最近很忙|I've been very busy recently.
你什么时候将去亚美尼亚|When will you go to Armenia?
她寫英語時很少犯錯|When writing English, she rarely makes a mistake.
別碰我的相機|Leave my camera alone.
汤姆在三年之后被杀了|Tom was killed three years later.
你吃過午飯了嗎|Have you eaten lunch yet?
她无法看着他的脸|She couldn't look him in the face.
上海人要树立上海新形象|The Shanghainese people must build up Shanghai's new image.
请帮我递下盐|Please can you pass over the salt?
您必须排队|You have to wait in line.
不论如何我认为它不错|In spite of everything, I think it's not bad.
汤姆老是发牢骚|Tom complains all the time.
他们会嫉妒|They'll be jealous.
做夢去|Dream.
孩子們跑下了山丘|The children ran down the hill.
不谢谢我不需要塑料袋|No thank you, I don't need a plastic bag.
他可能會改變心意|He might change his mind.
不用理他|Don't pay attention to him.
汤姆和玛丽没有把真相告诉我们|Tom and Mary weren't telling us the truth.
我知道您接下来会问“您毒杀了多少人”|And I know the next thing you're going to say is: "How many people have you poisoned?"
我喜欢数学|I like mathematics.
用优质材料做的家具卖得很好|Furniture made of good materials sells well.
我想特别强调这一点|I want to emphasize this point in particular.
我知道熬夜對身體不好|I know staying up overnight is bad for the body.
他建議她戒酒|He advised her to stop drinking.
妳把帽子戴反了|You put your hat on backwards.
痛|It hurts!
请您用中文或英文回答|Please reply in Chinese or English.
别理汤姆|Ignore Tom.
我上個星期忙得一點休息的時間也沒有|I've been so busy this past week that I've hardly had time to relax.
我看到天花板上有一只苍蝇|I saw a fly on the ceiling.
真是个好主意|That's really a great idea.
她帶著她所擁有的一切東西離家出走了|She left home with everything she owned.
吃肉对环境不利|Eating meat is bad for the environment.
我還住在我父親的房子裏|I still live at my dad's place.
有谁想一起去吃饭吗|Anybody wanna grab something to eat with me?
Juddy 看着我|Judy looked at me.
我MP3播放器的电池没电了|My MP3 player's battery was flat.
現實和幻想是很難區分的|Reality and fantasy are hard to distinguish.
我真想知道发生了什么|I really want to know what's going on.
我很惊讶你家居然有辆日本车|I'm surprised that your family has a Japanese car.
做夢不要錢|Dreaming costs nothing.
我们养了两只狗三只猫和六只鸡|We have two dogs, three cats, and six chickens.
他喜欢游泳|He is fond of swimming.
你比我记得好|You remember it better than I do.
汤姆在会议期间打瞌睡|Tom dozed off during the meeting.
笑容是壞心情的最佳藥方|Smiling is the best remedy for negative emotions.
這句話是什麼意思呀|What's the meaning of this sentence?
一棵大树在风暴中倒下了|A big tree has fallen in the storm.
乌克兰的首都是基辅|The capital of the Ukraine is Kiev.
你是來見湯姆的嗎|Are you here to see Tom?
记得查字典|Remember to use the dictionary!
煙從煙囪上升|Smoke is rising from the chimney.
谢谢我说完了|Thank you, I've finished talking.
我认识汤姆|I know Tom.
我們聊了一會兒|We had a chat for a while.
你為什麼學英文|For what reason are you learning English?
汤姆和玛丽没有其他人可以依靠了|Tom and Mary have nobody else they can rely on.
他要求我盡快回覆|He pressed me for a prompt reply.
我已经两周没有见过您了|It's already been two weeks since I saw you last.
这里允许拍照吗|Are we allowed to take pictures here?
这是初次的感觉好像天空般晴朗|The first time feels like a sunny day.
请关门|Please close the door.
燕妮正在看这本书|Yanni is reading this book.
当你不知道对方是否像你爱着对方一样爱着自己的时候便很难爱上一个人|When you do not know if someone really loves you as much as you love him, it is very hard to truly love him.
耶稣不是神|Jesus isn't God.
我聽不太清楚|I can't hear very well.
他住在哪里|Where does he live?
汤姆是魔法师|Tom is a magician.
他把他的房子出租二十年了|He rented his house for 20 years.
我想要回我的自行車|I want my bicycle back.
這是我見過最美麗的景色|This is the finest view I have ever seen.
走快一點不然你會錯過火車|Walk faster, or you'll miss the train.
乌克兰的首都是基辅|The capital of Ukraine is Kyiv.
他们已经取消了罢工|They already called off the strike.
你最喜欢哪一种酸奶|What sort of yogurt do you like best?
我不怕面對壓力,有問題的時候,我就會很快地想辦法去解決|I'm not afraid of facing pressure. When problems arise, I will quickly think of ways to find the solutions.
哪怕没有人陪我我也要去看这部电影|Even if no one goes with me, I still want to see this movie.
Timuçin在学波兰语|Timuçin learns Polish.
你爸呢|Where's your father?
原来你很倔|Originally, you were very stubborn.
来了!|Coming!
你如果咬我我也要咬你|If you bite me, then I'll bite you, too.
湯姆工作得多麼快啊!|How fast Tom works!
昨天是多雲|It was cloudy yesterday.
她懂音樂|She understands music.
可以便宜點嗎|Can you lower the price?
磁能生产电流的发明在电力领域非常重要|The discovery that electric currents can be produced by magnetism is extremely important in the field of electricity.
我的车不是棕的|My car is not brown.
我從那時起就沒有見過她|I haven't seen her since then.
發生意外是因為司機的駕駛技術差|The accident was due to bad driving.
她上個月在美國|She was in the United States last month.
多麼美好的一天啊|What a beautiful day!
你抽煙多久了|How long have you been smoking?
我用五分鐘就算好了那道題|It took me five minutes to solve the problem.
母親一定要我們在晚上七時前回到家中|Mother insists that we should be home by seven in the evening.
汤姆比玛丽大三岁|Tom is three years older than Mary.
他昨天看了一部最有趣的小说|He read a most interesting novel yesterday.
他躺在长凳上|He is lying on the bench.
湯姆看來準備好了|Tom seems to be prepared.
這個食物太鹹了|This food is too salty.
三年後戰爭開始了|The war began three years later.
我16岁了|I am sixteen years old.
昨晚你有没有去见汤姆|Did you go and see Tom last night?
旗帜是国家象征|A flag is a national symbol.
我们不得不把游戏搁到下周日了|We have to put off the game till next Sunday.
别像猪一样猛吃东西|Don't eat like a pig.
說英語不容易但是它很有趣|Speaking English isn't easy, but it's fun.
薩米是名電工|Sami is an electrician.
让我摸摸你的额头|Come feel my forehead.
湯姆沒回覆瑪麗|Tom didn't write Mary back.
我每天讀書三個小時|I study for 3 hours every day.
那么你下午到过几个地方|So how many places have you been to in the afternoon?
我以为你知道|I thought you knew.
现代的人想法不同|People today think differently.
你们住这里|You live here.
玛丽是个了不起的女人|Mary is a wonderful woman.
我的在床頭櫃上|Mine is on the nightstand.
汤姆被感染了吗|Is Tom infected?
他把感冒传染给我了|He gave me a cold.
他误认为我是一个英国人|He mistook me for an Englishman.
自從她在廚房裡摔倒後她不曾再到那裡|Ever since she fell in the kitchen, she hasn't been all there.
昨天晚上我没刷牙就去睡觉了|Last night, I went to bed without brushing my teeth.
好天气能持续到明天吗|Will the fine weather keep up till tomorrow?
“全世界的各位你们好”|"Hello, people of the world!"
他看起来很可疑|He looks suspicious.
你到底怎麼回事啊|What's your problem?
我看见他穿过了马路|I saw him cross the road.
您必须弥补损失|You must make up for the loss.
我们路上一帆风顺直到遇上暴风雪|We made good time until we ran into a blizzard.
我咳嗽还有点发烧|I have a cough and a little fever.
這班是去紐約的火車嗎?|Is this the train for New York?
她弄丟了一本書|She lost a book.
你什么时候去那里|When did you go there?
我發覺說英語很簡單|I discovered that speaking English was pretty easy.
你选好专业了吗|Have you chosen a major yet?
她翻了一页书|She turned a page of her book.
万幸没乘客受伤|Fortunately, no passengers were injured.
真正的好朋友並不是在一起就有聊不完的話題而是在一起就算不說話也不會覺得尷尬|Real friendship doesn't mean that you will never run out of things to say, but that you don't get embarrassed when you don't have anything to say.
我老婆非常喜欢苹果饼|My wife likes apple pie a lot.
老實說我其實想留在家中不想出外的|To tell the truth, I would rather stay at home than go out.
行|Okay.
你有朋友是醫生嗎|Do you have any friends that are doctors?
这只是幻想而已|That's just your imagination.
如果您同意, 我想給他這份工作|With your approval, I would like to offer him the job.
我们能在哪儿打电话|Where can we make a phone call?
經理命令要把所有房間儘快打掃乾淨|The manager ordered all the rooms to be swept clean as soon as possible.
攀登富士山後我得到了一首詩的靈感|After climbing Mt Fuji I got the inspiration for a poem.
在比萨斜塔的塔阴下坐着这城市的童话讲述家他正在吃一碟豌豆汤 之后他将给小孩子们讲述童话“豌豆上的公主”|In the shadow of the Leaning Tower of Pisa sits the town storyteller, eating a bowl of pea soup. After that he tells some children the fairy tale "The Princess and the Pea".
即使最乐观而言你也会被赶出这间房子|Best case scenario, you get kicked out of the house.
他非常了解他|He knows him very well.
这个铝铸件需要重刷一遍.|The aluminum castings must be brushed again.
這個孩子不再哭了|The child doesn't cry anymore.
如果是這樣的話就甚麼問題也沒有了不是嗎|If so, then there's no problem at all, is there?
他的馬跳過了柵欄|His horse jumped over the fence.
等我有錢了我就買它|If I get rich, I will buy it.
他可能已經好幾天沒吃東西了|He might not have eaten for days.
你為什麼去了東京|Why did you go to Tokyo?
父親不喝烈酒|My father drinks no spirits.
我们看见孩子上了车|We saw the child get on the bus.
約翰看起來很勇敢但其實是個膽小鬼|John is brave in appearance, but is in reality a coward.
我們提前吃了午飯|We had an early lunch.
直到会议结束之前都没人注意到她不在|Her absence went unnoticed until the end of the meeting.
別告訴他我在這|Don't tell him that I'm here.
我們也喜歡這個|We also like this.
他們考試失敗了|They failed the exam.
我們吃完早餐就出發吧|We shall start after breakfast.
趁汤没凉之前喝下|Eat your soup before it gets cold.
我可以登記這堂課嗎|Can I register for that class?
晚安|Good night.
不要哭我爱你|Don't cry. I love you.
无色的绿色的观念疯狂地睡觉|Colorless green ideas sleep furiously.
一輛卡車輾過一隻狗|A truck ran over our dog.
我妈在的时候别讨论这件事|Don't talk about it in my mother's presence.
“你什么时候回来呀”“看一下天气怎么样再说啦”|"When will you come back?" "It all depends on the weather."
他说用完这本书后会借给我|He says that he will lend me the book when he is done with it.
她工作做得亂七八糟|She made a mess of the work.
我的月经没来|My period hasn't come.
沒有人在房間裡|There isn't anyone in the room.
记者租了间很贵的房|The reporter rented an expensive room.
可以原谅我吗|Can you forgive me?
你去哪裡度假了?|Where did you go for vacation?
沒有太陽就沒有生命|Without the sun, there would be no life.
勞莉會游泳|Laurie knows how to swim.
請等到我回來|Please wait until I come back.
你不能回避官方政策|You can't avoid office politics.
我請不起律師|I can't afford a lawyer.
我今晚走|I'm leaving tonight.
我不能適應這裡的氣候|I can't adjust myself to the climate here.
我们在调查事故发生的原因|We are looking into the cause of the accident.
没发生什么特别的事|Nothing special happened.
你会跳多高就跳多高|Jump as high as you can.
你父亲是日本人|Your father is Japanese.
請確認帳單|Please add up the bill.
他把我所有的錢都搶走了|He robbed me of all my money.
我已经走了超过四个小时|I've been walking for over four hours.
今天就到此为止吧|Let's finish for today.
冬天过了|Winter is over.
我喜欢在纽约第五大街购物|I like shopping on Fifth Avenue in New York.
这里的天气有独一无二的特点|The weather here has its own unique characteristics.
我以前还真不知道你做饭这么好|Before now I had no idea that you could cook so well.
她发现这有点令她不快|She finds it a little distasteful.
我做不了這個|I haven't finished this.
你好我叫 Nancy|Hello, I am Nancy.
我們沿著河散步|We took a walk along the river.
湯姆想不到個好地方藏它|Tom couldn't think of a good place to hide it.
你是個真正的朋友|You're a true friend.
为什么不让你的嘴巴休息呢|Why don't you give your mouth a rest?
我不認識他他是誰|I don't know him, who is he?
不知何时春暖花开 今天早晨还下雪了|I don't know when spring will come and when the flowers will bloom. It was still snowing this morning.
特快火车正驶进轨道|The express train is moving down the track.
现在我全都明白了|Now I understand it all.
我确信汤姆是唯一不会那么做的人|I'm pretty sure Tom is the only one who can't do that.
這房子裏面有多少隻貓|How many cats are there in this house?
他没有白死|He didn't die in vain.
我從倫敦訂購了一些書|I ordered some books from London.
讓我們去野餐|Let's go to the picnic.
他有長頭髮|He has long hair.
這塊石頭太重了無法抬起來|This stone is too heavy to lift.
我搭計程車去的機場|I went to the airport by taxi.
我想跟你老板谈|I want to talk to your boss.
這張書桌是專門為兒童設計的|This desk is designed for children.
你太依賴別人了|You depend too much on others.
你明天要去上學嗎|Are you going to school tomorrow?
再也吃不下了|I couldn't eat another bite.
我的拉链卡住了|My zip is stuck.
我有许多问题|I have a lot of questions.
这部电影是我迄今为止看过的最好的一部|This is the best movie I've ever seen.
麥克說他會來|Mike said that he would come.
他們只在白天工作|They work only during the day.
他慢慢地适应了黑暗|He slowly got used to the dark.
葵的嗜好是跳舞|Aoi's hobby is dancing.
那该让你高兴|That should make you happy.
我已经知道你想要什么|I already know what you want!
那个学生正在学习社会学|That student's studying sociology.
你搞得定吗如果你愿意的话我可以帮你|Can you do it yourself? If you want, I can help you.
人必定要死的|Man is bound to die.
據說她是個知名的女演員|It's said that she's a well-known actress.
她去意大利是为了学习音乐|She went to Italy for the purpose of studying music.
谁能说将来会发生什么呢|Who can tell what will happen in the future?
我一把这本书读完了就借给你|I'll lend you the book as soon as I'm done reading it.
这把雨伞是你的吗|Is this your brolly?
她对她的孩子非常生气|She got very angry with her children.
汤姆做出了选择|Tom made a choice.
長號:狂野可能有趣但盡量不要發出粗啞的音符|Trombones: it may be fun to go wild, but try not to blat the notes.
根據報導昨晚有一場很大的火災|According to the newspaper, there was a big fire last night.
或许你就应该把汤姆开除掉|Maybe you should just fire Tom.
他已卧病在床四天了|He's been sick in bed for four days.
上海人讲上海话上海人也都会讲普通话|People from Shanghai speak Shanghainese; they can also speak Mandarin.
以前人們以為只有人類才懂得用語言溝通|People used to think that only humans could use language.
油价上涨的可能性很高|There is a good chance that gasoline prices will go up.
日本公司已經建立了品質的信譽|Japanese companies have built up a reputation for quality.
她慢慢地走這樣她就不會滑倒了|She walked slowly so she wouldn't slip.
我没有准备好|I'm not ready.
汤姆的朋友都很喜欢他|Tom is liked by his friends.
汤姆真的不会游泳吗|Is it true Tom can't swim?
我想做夢|I want to dream.
我们早上九点上课可是他八点就来了|We start class at 9am, but he came as early as 8 o’clock.
他幾乎從來都不會生氣|He almost never gets angry.
滑完雪后我发现我食欲大增|After skiing, I find that I have a voracious appetite.
不好意思讓我指出先前文章的三個錯誤|Excuse me, let me point out three mistakes in the above article.
透过窗我们可以看到很美的海景|We have a good view of the sea from the window.
我给你发了封邮件|I sent you an e-mail.
您的蛋糕很美味|Your cake is delicious.
我们只能滥用善良的|We can only abuse of things that are good.
試圖逃跑是沒有用的|It's no use trying to escape.
我最近压力有点大|I've been under a lot of pressure lately.
你们怎么搞的|What's the matter with you people?
勝利是用許多人的性命換來的|The victory was won at the cost of many lives.
廚房裡有咖啡嗎|Is there any coffee in the kitchen?
你很勇敢不是嗎|You're very brave, aren't you?
我們從那裡逃了出來|We made it out of there.
你的脚脏|You have dirty feet.
他拯救了我|He came to my rescue.
喂你还在吗|Hello? Are you still here?
我們有在這裡停車的許可|We got permission to park here.
麻雀正在树上唱歌|The sparrow is singing in the trees.
谁来告诉我到底发生了什么事|I am still waiting to be told what happened.
举起手来|Put your hands up!
這衣服是我同事的不是我的|This clothing is my coworker's, not mine.
自由是有代价的|Freedom is not free.
即使我的钱够了我也不会买一辆法拉利|Even if I had enough money, I still wouldn't buy a Ferrari.
這鞋不合我的腳|These shoes don't fit my feet.
做得非常好就照這個樣子繼續下去|You're doing very well. Keep it up.
她把蘋果切成兩半|She cut the apple in half.
汤姆要求有人解释|Tom demanded an explanation.
我想要租車|I want to rent a car.
你看起來有困惑|You look like you're confused.
我已經在字典裡查過這個字了|I have already looked up this word in the dictionary.
愛屋及烏|Love me, love my dog.
还剩一点水|There's some water left.
我不知道|I do not know.
说你想要哪个|Say which one you would like.
我緊緊地抱著他哭|I hugged him tightly and cried.
你的問題和我的相似|Your problem is similar to mine.
當我在你這個年紀時冥王星是行星|When I was your age, Pluto was a planet.
我十年前參觀了福岡|I visited Fukuoka ten years ago.
这条鱼没有毒|This fish is free from poison.
一点也不便宜贵得不得了|It's not even a little bit cheap, it's extremely expensive!
孩子想和大人一样表现|Children want to act like grown-ups.
我对你的大胆感到很惊讶|I am amazed at your audacity.
我和男友第一次约会就发生了性关系|My boyfriend and I had sex on the first date.
肯很快樂|Ken is happy.
我是Tom Hunter|I am Tom Hunter.
他们分房睡即使他们已经结婚了|They sleep in separate bedrooms even though they're married.
世界上有10种人懂二进制的人和不懂二进制的人|There are 10 types of people in the world: those who understand binary, and those who don't.
我无法判断距离|I can't judge distance.
你別想逃|Don't try to escape!
這是城裡最糟糕的旅館|This is the worst hotel in town.
哪裡坐出租車|Where can I take a taxi?
屁话|Rubbish!
再试一下|Try again.
你們學習嗎|Are you studying?
天氣暖和|It was a warm day.
其中一個孩子讓門開著|One of the children left the door open.
努力工作才能养活自己|Work hard so that you may earn your living.
他被严历批评|He was harshly criticised.
這應該不怎麼難|It seems easy enough.
我的夢想是要成為一個頂級的麻將高手|My dream is to become a very strong mahjong player.
湯姆拍了手|Tom clapped his hands together.
良善和喜樂比道德更加重要是我們所應盡的絕對義務|Gentleness and cheerfulness, these come before all morality; they are the perfect duties.
我能试一下吗|May I try it on?
我有一条狗|I have a dog.
花園裡充滿了花朵|The garden was filled with flowers.
他非常醉了|He's really drunk.
起床了太阳晒屁股了|Get up. It's late.
她非常喜欢她的学校|She likes her school a lot.
我想去游泳|I want to go swimming.
他有自己的房间|He has his own room.
你们有什么冷饮|What cold drinks do you have?
除了這個之外我會給你任何東西|I'll give you anything but this.
湯姆花了大半箇早晨整理辦公室|Tom spent most of the morning straightening up his office.
因為空氣汙染的問題也許有一天自行車會取代汽車|Because of the problem of air pollution, the bicycle may some day replace the automobile.
他的弟弟学习很认真|His brother studies very hard.
他想进一步了解他们|He wants to know more about them.
他看起来像个运动员但是其实是个作家|He looks like a sportsman, but he is a writer.
她要哭出来了|She was on the verge of crying.
你也是從波士頓來的嗎|Are you also from Boston?
我难受三周了|I've been unwell for three weeks.
我不喜欢小孩|I don't like kids.
公車一輛一輛地開出了|The buses left one after another.
有個陌生人從後面拍了拍我的肩我肯定他是認錯人了|A stranger tapped me on the shoulder from behind. He must have mistaken me for someone else.
我可以再吃一塊蛋糕嗎|May I have another piece of cake?
你最好尽快去做|You'd better do it soon.
这湖里有许多鱼|There are a lot of fish in this lake.
么女長得特別漂亮|The youngest daughter was particularly beautiful.
我這樣想是對的嗎|Am I correct in thinking thus?
他在工作中出了意外|He had an accident at work.
湯姆每天早上六點起床|Tom gets up at six every morning.
請在下箇星期日休息|Please take next Sunday off.
我比Tom好|I'm better than Tom.
她相信他|She trusts him.
这个盒子没那个盒子大|This box is not as big as that one.
你明天出去吗|Are you going out tomorrow?
他在一次車禍中受傷了|He was injured in a traffic accident.
汤姆是一个越军退役军人|Tom is a Vietnam veteran.
她會再試一次|She'll try it once more.
小雨他是胡安我和胡安是朋友|Xiao Yu, this is Juan, and I am Juan's friend.
您生气了吗|Are you mad?
他不是我男友他是我弟|He's not my boyfriend. He's my brother.
公車突然在路中央停下來|The bus stopped suddenly in the middle of the street.
噪音嚇到了嬰兒|The noise frightened the baby.
有很多人|There were lots of people.
人呢|Where did they go?
湯姆餵了羊|Tom fed the sheep.
他雖然只學了兩年的英文但也說得不錯|His English is not bad, seeing that he has studied for only two years.
他搬到了东京|He moved to Tokyo.
我小时候只穿裤子|As a child, I’d only wear trousers.
你隨時都可以來看我|Come and see me whenever you like.
你現在是大學生了應該努力點讀書|Now that you're a college student, you should study harder.
我没有想到汤姆会那么生气|I didn't think Tom would be so mad.
撒哈拉沙漠广袤无垠|The Sahara is a vast desert.
讓我一個人去|Let me go alone.
英语不是我的母语|English is not my native language.
生菜变黄了|The lettuce has turned brown.
我们和简交了朋友|We made friends with Jane.
我們要讀很多書|We have to do a great deal of reading.
已經過了五點鐘|It is already past five o'clock.
傍晚我喜歡沿著湖邊散步|At nightfall I like following the tradition of taking a walk along the lakeside.
街道两边有许多商店|There are many stores on either side of the street.
她當時像老太太一樣低著頭走路|She walked with her head down like an old woman.
我没在忙|I am not busy.
这是我第一次来澳大利亚|This is my first time to visit Australia.
汤姆饱了|Tom was full.
那個時候我還沒有結婚|I wasn't yet married at that time.
我喜欢郁金香和猫可是郁金香对猫咪有毒我该如何取舍呢|I like tulips and cats, but tulips are poisonous to cats. How should I choose?
我從前和你一樣窮|I used to be poor like you.
我去不了因爲那天我家人要來看我|I can't go. My relatives are visiting me that day.
我真的不懂这个问题|I truly do not understand the question.
所有成员都极为重视她的意见|All the members made much of her opinion.
君子對於飛禽走獸見到它們活著便不忍心見到它們死聽到它們哀叫便不忍心吃它們的肉|The superior man is affected towards animals: having seen them alive, he cannot bear to see them die; having heard their cries, he cannot bear to eat their flesh.
我认识那位长胡子德国人|I know that German with a long beard.
你們從前很好現在更好了|You all were very good before, and now you're even better.
我用三塊錢買了那本書|I paid three dollars for that book.
透过薄雾我隐约看见了我的未来|In looking through the mist, I caught a glimpse of my future.
从来就没有什么救世主 也不靠神仙皇帝|There has never been a savior nor an immortal emperor to rely on.
一片枯葉落到了地上|A dead leaf fell to the ground.
这里以前有邮局|There used to be a post office here.
Tom 太胆小了以至于做不了任何事|Tom was too afraid to do anything.
天气预报说明天会下雪|The weather forecast says it'll snow tomorrow.
我不那么在意|I don't care all that much.
我累得不能再累了|I'm as tired as tired can be.
房子被火吞噬了|The house was in flames.
奶奶去世让全家都受了打击|Grandmother's passing away came as a great blow to the entire family.
汤姆可不这么认为|Tom doesn't think so.
华盛顿的新保守主义者不该把航空母舰放到离俄罗斯和中国太近的地方这两个国家有能粉碎它们的武器|Washington's neocons should not push their aircraft carriers too close to Russia and China. These two countries have the weapons they need to pulverize them.
過馬路小心點總沒有錯的|You cannot be too careful in crossing a street.
等會兒見|I'll see you later.
我剛吃過午飯|I have just eaten lunch.
一個嬰兒在搖籃裡睡覺|A baby is sleeping in the cradle.
我太矮了|I am too short.
你從哪裡來|Where are you coming from?
新来的英语老师刚从大学毕业|Our new English teacher is fresh from college.
賭博網站讓用戶投注在將滅絕的物種上因為墨西哥灣漏油|Gambling site lets users bet on which species will go extinct because of the oil spill in the Gulf of Mexico.
英语不容易但很有意思|English is not easy, but it is interesting.
我差点没去澳大利亚|I almost didn't visit Australia.
狗绕着桌子走|The dog is walking around the table.
你每天都学习吗|Do you study every day?
别为玛丽犯的错责备汤姆|Don't blame Tom for what Mary did.
您来这儿干嘛|What did you come here to do?
甚至沒有一輛計程車停下來|Not even one taxi stopped.
好嘞|Fine!
他写了一本关于丛林冒险的书|He wrote a book about a jungle adventure.
你记事情的能力并不比我好多少|You are no better at remembering things than I am.
他們都是大學生|They are all students.
这应证了我的想法|That thought crossed my mind.
Tom出去辦事了|Tom is out on an errand.
电视台正在播足球赛|The football game is now on the air.
房間裏有沒有浴缸|Does the room have a bath?
我比较喜欢黑色的|I would prefer the black one, there.
我们在三楼|We're on the third floor.
你想喝點甚麼|What will you have to drink?
看看那边的考拉|Look at that koala over there.
老师说“当然可以”|Our teacher said: "Of course you can."
約翰現在在做什麼|What is John doing now?
她在节食|She is on a diet.
汤姆和玛丽不喜欢跳舞|Tom and Mary don't like dancing.
我是有志向的人清楚自己的目標|I'm someone ambitious - someone who knows very well what he is after.
我為你工作|I work for you.
我有個朋友的父親是知名的作家|I have a friend whose father is a famous writer.
走著瞧|Wait and see.
你在读书|You're reading.
我家有四個人|There are four people in my family.
你現在那又是什麼意思|What's that supposed to mean?
我覺得很難用一天就做完這麼多的工作|I don't think it's possible to finish that amount of work in one day.
电脑被用来通过电子邮件发送信息|Computers are used to send messages by e-mail.
他戴著面具以至於沒有人認出他|He wore a mask so that no one could recognize him.
我一无所知|I have no clue.
我需要尽快完成|I need to complete it as soon as possible.
爸妈今儿干啥了|What did Mom and Dad do today?
村里有一头母牛|There is a cow in the village.
仪式完成了|The ritual was completed.
醫生用X光檢查我的胃|The doctor used X-rays to examine my stomach.
“我們去打網球把” “好”|"Let's play tennis." "Yes let's."
我想要更详细的信息|I'd like more detailed information.
好死不如赖活着|Better to live dishonored than die proud.
湯姆回答我|Tom, answer me!
冰箱開著|The fridge is open.
湯姆還沒做完|Tom isn't finished yet.
他不在这儿你不觉得这很奇怪吗|Don't you think it's strange that he's not here?
她年轻天真而又缺乏阅历|She's young, naive and inexperienced.
今天上午我有一點兒發燒|I had a little fever this morning.
你肯定吗|Are you certain?
我打算去妓院做事|I plan to work in a brothel.
她妈妈来自西班牙她爸爸来自意大利所以她会讲西班牙语和意大利语|Her mom is from Spain and her dad is from Italy. That's why she can speak both Spanish and Italian.
我們去年搬家了|We moved house last year.
如果你有什麼不懂的就問|If there is something you don't understand, then ask.
女人的思维很有跳跃性从仰慕到爱慕从爱慕到结婚都是一眨眼间的事|A lady's imagination is very rapid; it jumps from admiration to love, from love to matrimony, in a moment.
Fabien有很多好点子|Fabien has a lot of good ideas.
我的牙很痛|My teeth hurt.
你想到几岁才结婚呢|By what age do you want to get married?
湯姆的評論不合適|Tom's comment was inappropriate.
我同意您的意見|I agree with your opinion.
她一时间拿不定主意不知如何是好|Suddenly unable to make up her mind, she didn't know what to do.
你想要什么|What do you want?
明天见|See you tomorrow.
我記得告訴過你了|I think I've told you.
这只是偶发事件|That only happens occasionally.
我想要跳舞|I'd like to dance.
她允许他一个人去|She allowed him to go alone.
你介意把你的車借給我嗎?|Would you mind lending me your car?
他在我來到之前就死了|He died before I arrived.
我只亲过她一次|I only kissed her once.
她是個愛忌妒的女孩|She's a jealous girl.
他們總是逃學|They always skip school.
讓我知道你住在哪裡|Let me know where you're staying.
我已经几年没回去波士顿了|I haven't been back to Boston in years.
我明天給你買|I'll buy it for you tomorrow.
穿上.|Put it on.
我要是个独子就好了|I wish I were an only child.
她買了一雙黑色的網襪|She bought a pair of black fishnet stockings.
除了汤姆和玛丽房间里没有人|There was no one in the room besides Tom and Mary.
他聽到那個好消息高興得跳了起來|He could not help jumping for joy at the good news.
我必須把我的電腦拿去給人家修理|I have to get my computer repaired.
她看起来对他感兴趣|She seems interested in him.
她每天都會練琴|She practises the piano every day.
男人正在用座机打电话|The man is making a telephone call.
她会在那儿但他不会|She'll be there, but he won't.
他几乎淹死|He almost drowned.
令我惊讶的是我的钱没了|To my astonishment, my money was gone.
你可以告訴我如何到火車站嗎?|Can you tell me how to get to the train station?
你午饭想吃面包吗|Would you like to eat a roll for lunch?
此刻你正在阅读并翻译这句|At this very moment, you're reading and translating this.
他张开双臂, 似乎要拥抱这个世界|He spread his arms, as though wanting to embrace the world.
她很喜歡吃巧克力|She is very happy to eat chocolate.
我可以带上汤姆吗|Can I bring Tom?
你對我做的任何事都不滿意|You're never satisfied with anything I do.
有軌電車三號線是去哪裡的|Where does tram number 3 go?
最小的兄弟姐妹一般都最漂亮|The youngest siblings are in general the most beautiful ones.
你想怎麼剪你的頭髮|How do you want your hair cut?
你應該考慮他們的宗教|You should think of their religions.
她太过好奇以至于打开了盒子|She was so curious that she opened the box.
桌子上有一臺電腦|There is a computer on the table.
湯姆說他會讓瑪麗去做|Tom said he'll ask Mary to do that.
我的狗總是跟著我|My dog goes everywhere with me.
汤姆好但不够好|Tom is good, but not good enough.
我比他高|I am taller than he.
在这种情况下形容词放在名词前面|In this case, the adjective goes before the noun.
北京欢迎你|Beijing welcomes you.
如果这两个文化有真实的不同我认为最大的准是在关于外国人学习自己的母语的意见|If there are genuine differences between these two cultures, I think that the largest are certainly in what you think about foreigners studying your native language.
他的脸上呈现了愤怒|Anger showed on his face.
他说话太快了|He speaks too fast.
我们相信上帝|We believe in God.
我對她毫無歉意|I don't feel sorry for her.
他是賣魚的|He is a fishmonger.
在墨西哥有很多貧民窟|There are many slums in Mexico.
真的|Really?
我今年去了好几次外国|I have been abroad several times this year.
我累死了|I'm exhausted.
他越激動就越安靜|The more excited he gets, the quieter he becomes.
那幢房子看起来被遗弃了|That house appears deserted.
汤姆不是川普|Tom is not Trump.
请把淋湿的伞放到这个袋子里|Put the wet umbrella in this bag, please.
他到了吗?|Has he arrived?
日元涨了|The Japanese yen appreciated.
您最好在外衣里穿一件套衫|You'd better wear a sweater under your jacket.
在青春期我厌倦生活并持续陷入自杀的边缘然而在那期间对数学知识的渴望使我抑制住了那些负面情绪|In adolescence, I hated life and was continually on the verge of suicide, from which, however, I was restrained by the desire to know more mathematics.
我希望没打扰到你吧|I hope I'm not disturbing you.
她是我妻子|She is my wife.
我們沒有必要參加會議|It is not necessary for us to attend the meeting.
你什么时候喝咖啡|When do you drink coffee?
他清了清喉嚨|He cleared his throat.
今天我有很多功課要做|Today, I have a lot of homework.
我會仔細考慮|I'll think it over carefully.
他说意大利语|He speaks Italian.
我最后一次见她是在伦敦|It was in London that I last saw her.
这个椅子坐着不舒服|This chair is uncomfortable.
我没有泄露这些照片|I didn't show those pictures to anybody.
在日本遇到人鞠躬是有礼貌的表现|In Japan, it is polite to bow when one meets someone.
如你所知|As you already know.
我吃苹果了|I ate apples.
他说他没有进房间那是骗人的|He said he did not enter the room, which was a lie.
這是誰寫的|Who wrote this?
战争不是轻易就应该开始的所以也不能够因为像打仗就改变宪法|War isn't something to be done lightly, also changing the constitution isn't something that should be done because "I just really want to go to war".
我承认我不太喜欢汤姆|I admit I don't like Tom very much.
下线去洗澡|Signing off, gonna take a shower.
拜託別跟他說我要走了|Please don't tell him that I'm leaving.
他的儿子于交通事故去世了|Her son was killed in a traffic accident.
日本的高校生每年要上三十五個星期的學|Japanese high school students go to school 35 weeks a year.
汤姆只是需要多一点时间|All Tom needs is a little more time.
他向我們提供了幫助|He offered his help to us.
我不喜歡他講話的樣子|I don't like the way he talks.
我说服汤姆帮我这么做|I talked Tom into doing that for me.
那個嬰兒似乎在熟睡中|The baby seemed to be in a deep sleep.
我完全不要牛奶|I don't want any milk at all.
她迷路了紧接着天开始下雨了|She lost her way and on top of that it began to rain.
科学家们还没有找到癌症的治疗方法|Scientists haven't found a cure for cancer yet.
我不知道他叫甚麼名字|I don't know his name.
他迫切的需要找到工作|He urgently needs to find work.
我要在這裡工作一整天|I was going to work here all day.
所有村民出发去山里寻找一只失踪的猫|All the villagers went into the mountains to look for a missing cat.
你明天来的时候我就看完这本小说了|I will have finished reading this novel by the time you come tomorrow.
学校怎么样|How are you doing in school?
祝一切都好|I hope everything goes well!
可以开窗吗|May I open the window?
请关门|Please shut the door.
車別開得那麼近|Don't drive that close to it.
哎马上就要考试了我死定了|Ah, it's almost time for exams. I'm dead!
成年人很難理解那些音樂|The music is difficult for grownups to understand.
阿尔及利亚需要摆脱官僚主义|Algeria needs to get rid of its bureaucracy.
我們沒有洗碗機|We don't have a dishwasher.
他们报告目击了事故|They reported seeing the incident.
附近有没有青年旅舍|Is there a youth hostel near here?
請先為他上菜|Please serve him his meal first.
我能教你迷住男人|I can teach you how to bewitch men.
你聖誕節要什麼珍妮|What do you want for Christmas, Jenny?
你在想啥呢|What are you thinking about?
你到底怎么回事嘛|What is wrong with you?
微风习习|A gentle breeze is blowing.
他從沒去過美國|He's never been to America.
大家好嗎|How's everyone?
地震災難的受害者非常多|The victims of the earthquake disaster are numerous.
请让我和平地生活吧|Let me live in peace.
他有一個女兒|He had one daughter.
湯姆應該不會做那麼蠢的事|Tom probably wouldn't do something that stupid.
我最近戒烟了|I have recently given up smoking.
每個機器人身上都安裝了一台發聲器|Each robot is equipped with a talking machine.
你在这里高兴吗|Are you happy here?
我8点开始工作|I start work at 8.
用俄語說|Say it in Russian!
我在波士頓成長|I grew up in Boston.
你脸红了|You're turning red.
乌古斯语支是突厥语系的一部分|Oghuz languages are part of the Turkic language family.
他是我的一位老朋友|He is my old friend.
刮的是北风|A north wind is blowing.
汤姆说他们需要更多时间|Tom says they need more time.
轻轻地移动|Move quietly.
她怕獨自旅行|She was afraid to travel alone.
我的消息对年轻人很重要|My message is important to young people.
我不是个母语者|I'm not a native speaker.
等等我|Wait for me.
原子反应堆发出大量的热能|The atomic reactor generates enormous amounts of thermal energy.
我是好人|I'm a nice guy.
我們希望湯姆沒事|We hope Tom is OK.
能再說一次嗎我沒聽清楚你的名字|I beg your pardon; I didn't quite catch your name.
他這個人很難相處|He is difficult to get along with.
但願我們贏了這場比賽就好了|I wish we had won the game.
星期天的時候你不用工作|You don't have to work on Sundays.
Youtube不是个好网站|YouTube is not a good website.
警察正在检查他们的包|The police are checking their bags.
他十七歲的時候離開了高中|He left high school at seventeen.
叉子从桌上掉了下来|A fork fell off of the table.
今天有风|It is windy today.
我不知道他也不知道|I don't know and neither does he.
你可以叫我鮑勃|You can call me Bob.
那辆车是三辆之中最漂亮的|That car is the most beautiful of the three.
你能分辨銀和錫嗎?|Can you tell silver and tin apart?
我们俩都经历过不幸|Worse things have happened to both of us.
他雖然擺着一副若無其事的樣子但是我想他心裏一定擔心得不得了|He'll never show it, but I think that deep down, he's seriously worried.
我是一名電腦科學家|I'm a computer scientist.
明天中午叫他打给我一个电话|Tell him to call me tomorrow at noon.
“没门儿”　“有的有门儿”|"No way!" "Yes, yes way."
我们这里没有任何乘橇的人|We don't have any sledders here.
我明年要去夏威夷|I am going to Hawaii next year.
我好餓|I'm really hungry!
我母親在水果店買了好幾個蘋果|My mother bought some apples at the fruit shop.
能不能请你把窗关了?|Would you please shut the window?
他的衣服過時了|His clothes are out of fashion.
你要不要我们给你叫辆出租车|Do you want us to call you a taxi?
他的懒惰是他未来不好的预兆|His laziness boded ill for the future.
他收起了他的玩具|He gathered his toys together.
你看上去很憔悴|You look worn out.
这是台前装式洗衣机|This is a front-loading washing machine.
你睡覺時穿睡衣嗎|Do you wear pajamas when you're sleeping?
哇她真是神速啊真让我印象深刻|Wow, she’s got a lot of pace, I’m impressed!
我不喜欢你的微笑|I don't like your smile.
我知道他来自哪里|I know where he comes from.
給丟到垃圾桶裡去|Toss it into the rubbish.
她不得不放弃梦想|She had to give up her dream.
我MP3播放器的电池没电了|The battery of my MP3-player was empty.
我看到他過馬路|I watched him cross the street.
安靜否則嬰兒會醒來|Be quiet, or the baby will wake up.
在雲的遮蔽下無法見到月亮|The moon is invisible behind the clouds.
你的胃會痛嗎?|Do you feel any pain in your stomach?
您很容易就能看出区别|You'll be able to see the difference very easily.
我的涂改液用完了现在写字只用铅笔|My correction fluid has run out, so now I only write in pencil.
抱歉我沒有早點回覆你|I'm sorry that I didn't reply to you sooner.
我问题的回答是什么|What's the answer to my question?
你真的相信鬼嗎|Do you really believe in ghosts?
这是我们的孩子|These are our kids.
萨米必须跟妹妹坐|Sami has to sit with his sister.
句子通常有主詞和動詞|A sentence normally has a subject and a verb.
我希望那會發生|I'm hoping that that'll happen.
這輛他正在開的車不是他的|The car he's driving is not his.
我们现在有了麻烦|We have a problem here.
玛丽的褐色眼睛很美|Mary has beautiful brown eyes.
我跟我姐姐共用同一間臥房|I share a bedroom with my sister.
在回家的路上我看到一场阅兵式|I caught sight of a parade on my way home.
下周我必须买一些新衣服|I have to buy some new clothes next week.
他被你迷住了|He's crazy about you.
你為甚麼跟湯姆結婚|Why did you marry Tom?
他的话就是命令|His word is law.
跟着岁数增长他变得比以前倔|As he grew older, he became more obstinate.
我为昨天发生的事道歉|I apologize for yesterday.
汤姆和玛丽都戴着褐色的帽子|Tom and Mary are both wearing brown hats.
我的车不是棕的|My car isn't brown.
還有五十公里就到巴黎了|It's fifty kilometers to Paris.
我很抱歉那么晚回家|I'm very sorry that I came home so late.
你有沒有被困在電梯裡過|Have you ever been stuck in an elevator?
你为什么生气|Why are you angry?
女王伊麗莎白一世於1603年去世|Queen Elizabeth I passed away in 1603.
我记不起昨天查的那个词的意思了|I can't remember the meaning of the word that I looked up yesterday.
當我們離開的時候誰來照顧狗|Who will take care of the dog while we are away?
我昨晚吐了|Last night I threw up.
她聘請他作程式設計師|She hired him as a programmer.
我不明白你们在说什么|I don't understand what you guys are saying.
日本從國外進口各種原料|Japan imports various raw materials from abroad.
演唱会大概开了三个小时|The concert lasted about three hours.
他的實際年齡比他看起來老得多|He is much older than he looks.
几天前我在站看到了他|I saw him at the station a few days ago.
我相信他會做得很好|I believe that he'll do fine.
我在五時左右起了床|I got up about five.
這家劇院可以坐下幾百人|This theater seats several hundred people.
缺一把勺子|There is a spoon missing.
我对国际象棋不感兴趣|I'm not interested in chess.
你是那個建議我們一起唱歌的人|You're the one who suggested that we sing together.
每箇人都想吃|Everybody wanted to eat.
别碰|Hands off!
今年雪比去年下得多|We had more snow this year than last.
可以给我一些茶水吗|Can I have some tea?
我幾乎不能走路|I can hardly walk.
你不喜歡巧克力對吧|You don't like chocolate, do you?
你固然是錯了但也不能怪你|On the one hand, you are wrong, but on the other hand, I can't blame you for that.
你什麼時候回家|When are you going home?
我下月可能去澳洲|I may go to Australia next month.
你的生意进展如何|How is your business going?
我给你发了封邮件|I sent an email to you.
我正想打電話給你你的電報就送來了|Your telegram arrived just as I was about to telephone you.
曾經有一位叫Alfred的國王|Once there lived a king whose name was Alfred.
湯姆忘記帶上他的攝像機|Tom forgot to bring his camera.
不要改變你的心意|Don't change your mind.
萨米已经看过电视上的每一个医学节目|Sami has seen every medical show on TV.
那場大火把整個小鎮燒成了灰燼|The big fire reduced the whole town to ashes.
她是个程序媛吗|Is she a computer programmer?
明天天气会好吗|Will the weather be good tomorrow?
京都的夏天很热|Summers are very hot in Kyoto.
我的孩子病了|My child is sick.
我想我给汤姆打电话比较好|I suppose I'd better phone Tom.
我接受了报价|I accepted the offer.
我房間裏沒有電視機|There is no TV in my room.
鈴木先生在去法國之前學習法語|Before going to France, Mr. Suzuki studied French.
我已經吃晚飯了|I've already eaten dinner.
我很穷|I'm poor.
我們對他的過去進行了調查|We made inquiries into his past.
我已经看完这本书了|I've already finished reading this book.
我使用这个|I use this.
我们知道我们的权利|We know our rights.
他把他的行李留在車站|He left his luggage at the station.
老闆在的時候他就裝成一副很熱心的樣子|He pretends to be enthusiastic when his boss is around.
還沒有任何評論|There are no comments yet.
你需要什麼?|What is it that you need?
那个男人在一周前死于肺癌|That man died of lung cancer a week ago.
他们过着和平的生活|They live in peace.
他們可能錯過了火車|They may have missed the train.
他在西伯利亞待過七年|He spent seven years in Siberia.
你可以从银行贷款|You can get a loan from a bank.
你在学校学些什么呀|What are you learning at school?
我的祖父每天早上都會去散步|My grandfather takes a walk every morning.
当我无家可归的时候我常在那张长椅上睡觉|I often slept on that bench when I was homeless.
爸爸一直都在鼓励他|Dad's always encouraging him.
你工作很忙嗎 ?|Are you busy at work?
先生请别生我的气我是新来的工人|Please don't get mad, sir! I'm a new worker!
買票就麻煩你了|I'll leave it to you to buy the tickets.
還有其他建議嗎|Are there any other suggestions?
您吃不吃辣椒|Do you want pepper on it?
我发现了我爸爸收藏了30年的报纸|I discovered my father collected 30 years of newspapers.
这些鞋子真是要了我的命|These shoes are killing me.
秘书把信塞到一个信封里|The secretary stuffed the letter into an envelope.
汤姆正在等着玛丽回来|Tom is waiting for Mary to come back.
我不是很擅長游泳|I'm not very good at swimming.
我已经醒了一会儿了|I've been up for a while.
他們沒看到我們|They didn't see us.
她很聪明不是吗|She is smart, isn't she?
這本詞典是我自己選的|I chose this dictionary of my own accord.
进一步的检查发现头骨受到剧烈的撞击而碎裂|Another step forward revealed that the skull had received violent impact and disintegrated.
鈴聲在八點鐘響起|The bell rings at eight.
你為何沒有在牢裡|Why aren't you in jail?
我剛才吃了壽司喝了啤酒|I've just eaten some sushi and drunk a beer.
Yumi的韩文越来越好|Yumi keeps getting better at Korean.
你爸呢|How about your father?
有個女人從船上掉進了海裏|A woman fell from a ship into the sea.
我好餓|I'm so hungry!
你不是救了我的那箇人嗎|Aren't you the one who saved me?
許多老百姓加入了軍隊|A great number of citizens went into the army.
他说话太快了|He talks too fast.
甚至在這些國家以外英語也許比其他任何語言更廣泛地被使用來當作國際交流的媒介|And even outside these nations, English is perhaps more widely used as a medium of international communication than any other language.
我很渴|I'm very thirsty.
他们做完了|They were finished.
你的弟弟真是個奇妙的人|What a marvelous person your brother is!
我好像丢了我的钥匙|It seems that I've lost my keys.
如果你的孩子很辛苦你觉得日子很漫长|If your children are being tiresome, you will feel time passing slowly.
我吃飽了所以我的胃都滿了|I've had enough, so my stomach is full.
他卖旧地毯|He sells old carpets.
我记得在哪儿听到过那首音乐|I remember hearing that music somewhere.
这是你的兴趣爱好吗|Is this your hobby?
參賽條件非常嚴格|The contest has very strict eligibility requirements.
他们去年到法国度假|They vacationed in France last year.
別怕吠犬|Don't be afraid of barking dogs.
我要你離我遠一點|I want you to get off my back.
一旦撿到一顆你喜歡的石頭盡快將它帶回家並好好對待它因為那是妳唯一得到的石頭|Once you've picked up a stone that you like, take it home as soon as you can and treat it well, because that's the only stone you've got.
你看到我父亲了吗|Have you seen my father?
我儿子十岁了|My son is ten years old.
好吃嗎|Does it taste good?
你每天都喝酒嗎|Do you drink alcohol every day?
最后他们感受到了胜利的喜悦|At last, they experienced the joy of victory.
谁发明了电话|Who invented the telephone?
屁话|Nonsense!
她看不起我|She despises me.
鮑勃在學校很受歡迎|Bob is popular at school.
你有碗盛湯嗎|Do you have a soup bowl?
罐子是空的|The can is empty.
你怕死嗎|Are you afraid of death?
我希望你不要讲谎话|I hope you stop telling me lies.
這條村的東西比我們村的便宜多了|The things in this village are cheaper than those in ours.
我們應該去哪裡|Where should we go?
赶上时髦|Get with it.
他花了一大笔钱来帮助穷人|He spent a lot of money on helping the poor.
她在校外見到沒家的人住紙板箱|Outside the school, she saw people with no homes living in cardboard boxes.
我今早起床时我爸已经吃过早饭了|My father had already finished breakfast when I got up this morning.
你看過紅色的河嗎|Have you seen the red river?
我们认为这份报告是假的|We considered the report as false.
沒人知道她的名字|No one knows her name.
你哥哥結婚了不是嗎|Your brother got married, didn't he?
你也不是省油灯|You're no prize yourself.
她看起來不快樂|She seems to be unhappy.
您的帮助对我们来说是必不可少的|Your assistance is indispensable for us.
你們藏了什麼東西|What did you guys hide?
湯姆能給我們買來嗎|Can Tom buy that for us?
我不喜歡那樣的玩笑|I don't like those kinds of jokes.
Melissa喜欢吃桃子挞|Melissa is fond of eating peach tarts.
他不喝酒了|He doesn't drink anymore.
人會隨著年齡的增長而更加地玩世不恭|People grow more cynical with age.
你不能有秘密|You can't keep a secret.
我只想要一个明确的答案|I just want a clear answer.
我甘心为你做任何事|I'm ready to do anything for you.
明天早上我會打電話給你|I'll call you tomorrow morning.
黑暗中突然有一隻狗冒了出來把我嚇了一跳|I was shocked by the dog that sprang out of the darkness.
我喜欢在队伍里|I like being on the team.
我有一輛自行車|I've got a bike.
味蕾很有用|Taste buds are very useful.
已将近十点了该是睡觉的时候了|It's close to ten o'clock. It's about time we went to bed.
人生里的第一次Yuka 读完了一本英语书|For the first time in her life Yuka finished reading an English book.
贸易支付差额是所有的钱从国外进入一个国家的所有的钱走出去的国家在同一时期|The balance of payments is the total of all the money coming into a country from abroad less all of the money going out of the country during the same period.
她繼續工作|She kept on working.
您不必感谢我|You're welcome.
此事与我无关|This has nothing to do with me.
她是护士|She's a nurse.
你真的在考慮你这把年纪还重婚吗|Are you seriously thinking about getting married again at your age?
今天是星期一|It's Monday today.
汤姆似乎没有被吓到|Tom didn't seem to be intimidated.
我有四个孩子|I had four children.
攀山是種既緊張刺激又具挑戰性的運動因此特別受年青人歡迎|Mountaineering is attractive especially to young people because it is accompanied with hardships and adventures.
这样做很有趣|Doing this is a lot of fun.
虽然有人来了但是她还是忐忑不安|Even though someone came, she still remained uneasy.
我忘記了他的名字|I forget his name.
汤姆说他需要更多钱|Tom said that he needed more money.
你借酒浇愁是为了什么事|What pain are you trying to cover up with alcohol?
他对我很好|He is good to me.
我兄弟在東京上大學|My brother goes to college in Tokyo.
除了下雨天以外他每天都會走路上班|He goes to work on foot every day except on rainy days.
来看看世界地图|Have a look at the world map.
你想再來些蛋糕嗎|Would you like some more cake?
我在公園里找到了些錢|I found some money in the park.
老师对大家说“我们的婚礼现在开始”|The teacher said to everyone: "Our wedding is starting now."
你在说我有生命危险吗|Are you saying my life is in danger?
给我另一个例子|Give me a different example.
约翰·道尔顿是原子学说的创始人|John Dalton was the creator of the atomic theory.
在看考試卷前我有話要說|Before we look at these test papers, I have something to say.
雖然正在刮暴風雨但他還是出去了|He went out in spite of the storm.
他看起來很強壯|He looks strong.
喂这里有个会说维语的美国人快来把他的电脑检查一下|Hey! There's an American who speaks Uyghur here! Hurry up and get over here to inspect his computer!
你應該戒菸|You should quit smoking.
湯姆拿起了刀|Tom picked up the knife.
赶快回家|Hurry home.
你好啊早上好|Hello! Good morning!
我希望你更加努力地工作|I expect you to work harder.
他对纽约了如指掌|He knows New York inside out.
你不能把你的车停在这里|You can't park your car here.
他铁石心肠|He has a heart of stone.
我要成为一名护士|I want to become a nurse.
別哭|Don't cry.
歡迎來到三藩市|Welcome to San Francisco.
請拍手|Please clap.
他不愛說話|He's not a talkative person.
美國的小孩聽著這些話長大|American children grow up hearing those words.
我在沙發上睡的|I slept on the sofa.
因为住过东京我对这个城市非常了解|Having lived in Tokyo, I know the city well.
你需要多少錢|How much money do you need?
小林的眉毛长得浓眼睛又大睫毛很长|Xiaolin's eyebrows are thick, his eyes are big, and his eyelashes are long.
湯姆確實貪|Tom certainly is greedy.
我們警告過她|We did warn her.
母親做了一個聖誕蛋糕給我|My mother made me a Christmas cake.
您似乎不喜歡他|You don't seem to like him.
“到维也纳步行要多久”　“对不起我是外地人”|"How long does it take to get to Vienna on foot?" "Sorry, I'm a stranger here."
我總是在外面吃飯|I always eat out.
所以之前我認為我的約會或者更確切的說下線後的網聚將只有我和她但是事情並非那麼簡單|So I thought my date, er rather, offline-meeting was going to be just me and her but things aren't that easy.
這間游泳學校每個月的學費是多少|How much is the monthly fee of this swimming school?
可恶家的钥匙到底放哪去了?|Shit, where the fuck did I put my home keys?
我得给汤姆打电话|I have to call Tom.
我想去朝鲜|I want to go to North Korea.
我做完我的功课后就读这本书|This is the book I read after finishing my homework.
水龙头在滴水|The faucet is dripping.
汤姆可以帮我们吗|Can Tom help us?
這是本值得一看的書|This is a book worth reading.
我不知道汤姆不开心|I had no idea Tom wasn't happy.
湯姆剛從郵局回來|Tom has just returned from the post office.
汤姆每天用推特|Tom uses Twitter every day.
法语太难了我不想学|French is too hard. I don't want to learn it.
昨天我收到了她的信|I received her letter yesterday.
你讓窗戶開著嗎?|Did you leave the window open?
你常去慕尼黑嗎|Do you often go to Munich?
他曾在河内工作过|He has worked in Hanoi before.
她的脸顿时红了|Her face turned red suddenly.
讓我們放風箏|Let's fly a kite.
鮑勃很晚回家|Bob came home very late.
這把刀一點也不快|This knife is not at all sharp.
她渴望住在澳洲|She is eager to live in Australia.
像傻瓜一樣|You're just like a fool!
他是一名漁夫|He's a fisher.
他在五年前創立了這所學校|He founded the school five years ago.
我能了解她在說什麼|I can understand what she is saying.
我们的来了|Ours has come.
火车站离这里不远|The train station is not far from here.
他正在散步|He is taking a walk.
珍比蘇珊更吸引人|Jane is more attractive than Susan.
一百年才出一个周立波|A person like Zhou Libo is only born once every hundred years.
这就是我和妻子第一次见面的咖啡馆|This is the coffee shop I first met my wife in.
你有两本书吗|You've got two books?
今天的氣溫升高到攝氏三十度|Today, the temperature rose as high as 30 degrees Celsius.
湯姆是乾净的|Tom is clean.
他有五本以上的字典|He has more than five dictionaries.
火警發生在他們住的旅館|A fire broke out at the inn where they were staying.
我们按例处罚了他|We punished him according to the rules.
你在呼吸嗎|Are you breathing?
福特先生現在安好|Mr Ford is all right now.
一切都很糟糕|Everything is bad.
你有弗雷迪的消息嗎|Have you heard from Freddie?
海伦害怕地发出尖叫|Helen screamed in fear.
雨讓我們沒有辦法去散步|Rain prevented us from taking a walk.
噗真冷|Brr! So cold!
什么时候开始下雨的?|When did it begin to rain?
看來快要颳暴風雨了|It seems that there will be a storm soon.
你們要米飯嗎|Do you want rice?
我是一个认真的文员在家里我是一个好妻子兼好母亲|I'm a serious office lady and a good wife and mother at home.
你會愛它|You'll love it.
他賣了一台豐田的車|He bought a Honda.
萨米是个服务员|Sami is a server.
河边的老教堂很漂亮|The old church by the lake is very beautiful.
汤姆变胖了|Tom got fat.
能不能请你重复一下|Could you please repeat that?
這把叉子是髒的|This fork is dirty.
进来|Come on in.
你为什么对我生气|Why are you angry with me?
听其声而知其鸟闻其声而知其人|A bird is known by its note, and a man by his talk.
我跑得尽可能快|I ran as fast as possible.
他是我的同学|He is my classmate.
有些人喜欢运动有些人不喜欢|Some people like sports, and others don't.
他們明天晚上都會去北京大學上課|Tomorrow night, they will all go to Beijing University to attend class.
我贊成你的計劃|I approve of your plan.
坐飛機去沖繩要花多長時間|How long does it take to go to Okinawa by plane?
我们已经十多年没见过他了|We haven't seen him for over ten years.
我想吃大盘鸡|I want to eat a Dapanji!
我知道有些事不對|I knew that something was wrong.
他向那位女士问好|He saluted the lady.
我住了一個星期的醫院|I was in hospital for a week.
我們從印度進口茶葉|We import tea from India.
明天打电话给我|Give me a ring tomorrow.
如果他是清白的那他妻子就有罪|If he is innocent, then his wife is guilty.
我是足球的忠实粉丝|I'm a big football fan.
你想喝点什么吗|Do you want to drink anything?
汤姆往他的面包片上放了许多蜂蜜|Tom put a lot of honey on his toast.
来吧快一点|Come on, hurry up.
我看见他穿过了马路|I saw him crossing the street.
他说的话根本毫无意义|The things he says are not the least bit important.
瑪麗給她自己買了支新牙刷|Mary bought herself a new toothbrush.
这将是我环绕美国旅行中一个很好的纪念品|This will be a good souvenir of my trip around the United States.
繼續工作|Continue working.
我想用現金支付|I'd like to pay in cash.
我现在还没有吃过午饭|I haven't eaten lunch yet.
正义终将胜利|Justice will prevail in the end.
我想乘地铁去|I want to get there by subway.
你应该注意你的举止|You should behave carefully.
小聲一點啦|Lower your voices!
她開始在我的記憶中消散|She had begun to recede in my memory.
他的母親坐在他的左邊|His mother is sitting to his left.
Facebook 和 Twitter 的不同在于Twitter 是微博服务|The difference between Facebook and Twitter is that Twitter is a microblogging service.
你不在的時候誰照看狗|Who took care of the dog while you were away?
下个星期见|See you next week!
我看到死者们|I see dead people.
至于你信不信由你我反正信了|Whether you believe it or not, I believe it.
這些都是阿爾泰語系的語言|These are all languages of the Altaic language family group.
我們常常在放學後下棋|We often played chess after school.
我希望汤姆走开|I wish Tom would just go away.
花瓶摔成碎片了|The vase crashed and shattered into pieces.
汤姆会自己做吗|Will Tom do that by himself?
再试一次|Try it once again.
那个作家生活在小木屋中|The writer is living in a log cabin.
子女培养全社会都很关心教育要进行改革|The raising of children is something that concerns the entire community. There will be an education reform.
你的夢想成真了|Your dreams have come true.
這件外套是防雨的|This coat is rainproof.
到处都是血|Blood was everywhere.
我父親是一個中學英文教師|My father teaches English at a high school.
你们去哪儿?|Where are you guys headed?
我的哥哥是很狂热的足球迷|My older brother is a very enthusiastic soccer fan.
变化太小察觉不出来|The change is too small to be observed.
葡萄牙和西班牙是邻居|Portugal and Spain are neighbors.
肯下棋打敗了我|Ken beat me at chess.
他对他的行为感到后悔|He is regretting his action.
他的祖国是德国|His home country is Germany.
晚安蒂米|Good night, Timmy!
汤姆有心脏病|Tom has a heart condition.
他能跑得比我快|He can run faster than I can.
我應該把我要洗的衣服放在哪裡?|Where should I put my laundry?
我們在吃晚餐|We are having dinner.
她表演得真好|Her performance is really good.
我想去高山过节|I'd like to go to Takayama during festival time.
我一直想養寵物|I've always wanted a pet.
我討厭插隊的人|I hate people cutting queues.
汤姆说了一整晚|Tom kept talking all night.
不浪費則不匱乏|Waste not, want not.
我要去上廁所|I need to go to the toilet.
你们对外语感兴趣吗|Are you interested in foreign languages?
雨让秋天的日子阴沉沉的|The rain made the autumn day dismal.
上星期天我的家庭去了动物园看熊猫|My family went to the zoo to see pandas last Sunday.
这已经是你该刷牙的时间了|It's already time to brush your teeth!
我將在六月跟他結婚|I'm getting married to her in June.
你在昨晚的聚會上盡興了嗎|Did you enjoy yourself at the party last night?
无意冒犯|No offense!
电脑死机了|My computer has frozen.
你昨天有沒有打電話給他|Did you call him up yesterday?
我不调皮|I am not mischievous.
人人生来平等|All men are created equal.
你對我說了謊, 沒有嗎?|You lied to me, didn't you?
Tom不喜欢Mary|Tom didn't like Mary.
我父亲是个大夫|My father's a doctor.
现代交通使我们能在几天内环绕地球|Modern travel enables us to go around the world in a few days.
我们会在我的办公室见面|We'll meet in my office.
谁也不要摸这个|Nobody wants to touch this.
"那個人在說什麼?" "他一點也無法用俄語溝通所以我用俄語責備他"|"What was that person saying?" "He couldn't communicate in Russian at all so I told him off in Russian."
我們去馬克家吧|Let's go to Mark's place.
萨米写信给蕾拉说了这件事|Sami wrote to Layla about it.
你乘飞机还是乘火车去|Are you going by air or by train?
爱迪生不是个优秀的学生|Edison was not a bright student.
我和他比賽跑步|I ran a race with him.
我二十五岁了|I'm 25 years old.
我想成为决策的人|I want to be the one who decides.
安迪是精通法語和德語|Andy is master of French and German.
如果沒有了水沒有人能夠在地球上生存|If it were not for water, no one could live on earth.
我再也忍受不了她了|I can't bear to deal with her anymore.
我听说她下个月结婚了|I hear she is going to get married next month.
土豆很便宜的|Potatoes are very cheap.
逃避現實|Escape from reality.
大家爲什麼都在看著我|Why is everyone looking at me?
汤姆没受伤|Tom wasn't hurt.
我错过了奥运会的开幕式|I missed the opening ceremony of the Olympics.
对我来说这就不是个问题|For me, this isn't a problem.
就我所知他是无罪的|As far as I know, he is innocent.
我已经活了大半辈子了|I've already lived most of my life.
我听说你病了|I've heard you've been sick.
应该趁年轻多读点书|One should read many books when one is young.
明天你可以看到他|You will be able to see him tomorrow.
生活第一|Life first!
女孩在教室的角落啜泣|The girl was sobbing in the corner of the schoolroom.
英語是溝通的工具|English is a communication tool.
我看見了一個不明飛行物|I have seen a UFO.
如果你加热冰它就会融化|If you heat ice, it melts.
你认为那公平吗|Do you think that was fair?
电话响的时候我在看电视|When the phone rang, I was watching TV.
然後發生了什麼事|What happened then?
我希望我们能保持联系|I hope we stay in touch.
我哥哥應該生病了|My brother must be sick.
你應該去看牙醫把牙拔掉|You should go to the dentist and have that tooth pulled out.
我刚跟她谈话|I was just talking to her.
你有多喜歡這場音樂會|How did you enjoy the concert?
我偶尔做|I seldom do that.
他等火车的时候一会儿听音乐一会儿发短信|While he was waiting for the train, he listened to music and sent text messages.
那只黑鸟不是乌鸫|That black bird isn't a blackbird.
今天下午我會再見到你|I'll see you again this afternoon.
公园里有很多人|There's lots of people at the park.
你可以给我举个例子吗|Can you give me an example?
他把他的書分為五類|He divided his books into five categories.
不清楚她是什麼意思|It wasn't clear what she meant.
湯姆跟瑪麗是背包客|Tom and Mary are backpackers.
你从昨天开始就忙吗|Have you been busy since yesterday?
這是一張我的全家福照片|This is a picture of my family.
他喜歡我嗎|Does he like me?
汤姆被囚禁了|Tom is being held captive.
那边的那个女子是安娜|That woman over there is Ana.
我对那位女士印象不深|I don't remember much about that woman.
Tom, 晚餐想吃啥|Tom, what would you like to have for dinner?
這架飛機安全著陸了|The airplane made a safe landing.
她搭計程車到博物館|She went to the museum by cab.
听说大数据技术现在很热门|I hear that the network is very popular now.
她們錯了|They are wrong.
看见我她很尴尬|Seeing me, she was embarrassed.
我戒菸了甚麼時候戒的兩天前|"I've stopped smoking." "When?" "Two days ago."
这块蛋糕很好吃的请吃一块吧|This cake is delicious. Please have some.
您有很多书|You have many books.
他在读书中度过夜晚.|He spent the evening reading.
汤姆遇上麻烦了|Tom got into trouble.
汤姆从来没完全恢复|Tom never recovered completely.
他正忙着做作业|He's busy with his homework now.
我講因特語|I speak Interlingua.
这是我最喜欢的颜色|This is my favourite colour.
在您的國家說什麼語言|What languages are spoken in your country?
喝了幾杯酒後這個傢伙就感覺不痛了|After a couple of drinks, the guy was feeling no pain.
湯姆高興|Tom's happy.
你儿子正在和我女儿约会|Your son is dating my daughter.
不用給我買東西|You don't have to buy me anything.
对不起我迟到了|Pardon my being late.
請你把鹽遞過來好嗎|Would you pass the salt, please?
我的舅舅在彈吉他|My uncle is playing the guitar.
我的位子在哪儿|Where is my seat?
一篇大學論文描述了充斥在西方科幻作品中的東方主義|A university thesis describes the "Orientalism" that imbues sci-fi in the West.
湯姆在瑪麗身上施了咒語|Tom cast a spell on Mary.
恭子正躺在草地上|Kyoko is lying on the grass.
车取代了自行车|Cars took the place of bicycles.
我們都為Tom感到遺憾|We all felt sorry for Tom.
我已經吃晚飯了|I have already finished dinner.
他們當時很富有|They were wealthy.
我不喜欢鸡蛋|I don't like eggs.
該學生把考試卷交給了老師|The student handed the examination papers in to the teacher.
她决定长期住在美国|She has decided to live in America for good.
昨天是谁把窗子打破的|Who was it that broke the window yesterday?
他對她大灌迷湯|He's talking very sweetly to her.
你相信鬼存在吗|Do you believe ghosts exist?
今年我们会盈利的|We'll be profitable this year.
他因为生病了所以不能来拜访|He can't come and visit because he's ill.
你在家吃过了吗|Did you already eat at home?
阿什兰也有水|There's water in Ashland, too.
湯姆在這裡沒有可做的事|Tom has nothing to do here.
謝謝你邀我參加派對|I'm grateful to you for inviting me to the party.
希望他明天會來吧|I hope he comes tomorrow.
实话说我不赞成你|Frankly speaking, I don't agree with you.
他們的父親是一個計程車司機|Their father is a taxi driver.
我有五个以上的朋友会说法语|I have more than five friends who can speak French.
我以前从没听说过利沃夫|I had never heard about Lviv before.
你們被邀請了嗎|Were you invited?
他們要他再做一次這個工作|They made him do the work again.
有人会开车吗|Is there anybody who can drive a car?
你记得这是在哪一年发生的吗|Do you remember which year it happened?
她不介意要洗碗|She didn't mind doing the dishes.
知道真相的人只有幾個|Only a handful of people know the fact.
请给我统统说清楚什么时候在哪里发生了什么事|Please tell me in complete detail what occurred, when and where.
湯姆對孩子們生氣|Tom got angry at the children.
你该结束这种愚蠢的行为了|You must put an end to this foolish behavior.
傑克收集郵票|Jack collects stamps.
这些天John喝得太多了|These days John drinks too much.
你們得走了|You have to leave.
天上没有云|There's not a cloud in the sky.
那是一只鹳还是一只苍鹭|Is that a stork or a heron?
敏夫喜歡誰?|Who does Toshio like?
你去过哪些国家|Which countries have you visited?
我知道你比我有錢|I know that you're richer than I am.
存在的意义是什么|What's the point of existence?
他没有注意她|He paid no attention to her.
太多了|That's too much.
外国人很有意思|Foreign people intrigue me.
第二优秀是远远不够的|Second best is never enough.
她企圖自殺|She tried to commit suicide.
它不匹配的拉丁之一|It doesn't match the Latin one.
我看见那儿有个很美的瀑布|I saw a wonderful fall there.
这辆车是布莱恩的|The car is Brian’s.
試衣間在哪裏|Where is the changing room?
我的文件在那個箱子裡|My papers were in that box.
等一下|Wait a moment.
我明天会很忙|I will be busy tomorrow.
槍擊是在中午十二時左右開始的|The shooting started around noon.
你看上去不太好|You don't look so good.
我的计划是参观苏格兰的古堡|My plan is visiting old castles in Scotland.
我聽到了遠處的狗叫聲|I heard a dog barking in the distance.
从别人的错误中学习因为你无法所有事都亲身经历一次|Learn from the mistakes of others. You can never live long enough to make them all yourself.
戈登對日本的生活方式感興趣|Gordon is interested in the Japanese way of life.
你打電話給你在加拿大的朋友了嗎?|Did you call your friend in Canada?
我想和约翰格特死在一起|I want to die with Getter Jaani.
不要再让这种事发生了|Don't let that happen again!
我找不到我的鞋子|I can't find my shoes.
我會試試看|I will give it a try.
請檢查一下正確答案|Please check the correct answer.
对于这份工作来说我的年龄太老了|I'm getting too old for this job.
我們最大的敵人不是別人可能是自己|Our biggest enemies may not be other people, but ourselves.
我怀疑汤姆已经厌烦这么做了|I suspect Tom is tired of doing that.
微笑並不一定表示高興|Smiles do not always indicate pleasure.
他裁開了那個信封|He cut the envelope open.
話多不如話少話少不如話好|It's better to speak less than to speak too much, and it's better to speak well than to speak too little.
我去和朋友喝了杯啤酒|I went to drink a beer with my friends.
为什么这有警察|Why are the police here?
他們不理眾人的反對結了婚|Everyone opposed it, but they got married all the same.
你會記帳嗎?|Can you do bookkeeping?
我在安慰瑪麗|I am consoling Mary.
白天漸漸地越來越長|The days are getting longer and longer.
我前天買了台相機|I bought a camera two days ago.
古代的探險家用星星來辨別方向|Early explorers used the stars for navigation.
请马上离开|Leave now!
她坚持让我去看医生|She insisted that I should see the doctor.
麻煩再來一杯威士忌和加水|Another Scotch and water, please.
我们要设法跟他们交流|We have to try to communicate with them.
这个艺术家画国画|This artist does Chinese painting.
希望她會早日痊癒|I hope that she will get well soon.
日本的文化深深地影響了東亞|Japan's culture has deeply affected East Asia.
我想吃點東西|I want something to eat.
這些蘋果宜於烹飪|These apples are good cookers.
這個班只有三個女生|There are only three women in this class.
请在7点到8点钟之间打电话给我|Please call me up between seven and eight.
我们都喝醉了|We were both drunk.
有時等待很難|Sometimes, waiting is very difficult!
他總是在挑剔別人的毛病|He is always finding fault with others.
自私不是我的本意|I didn't mean to be selfish.
我叫你買牛肉没叫你買豬肉|I asked you to buy beef, not pork.
其实他也爱着她|In fact, he too loved her.
他們很努力地超過對方獲得優勢|They tried very hard to gain an advantage over one another.
我真喜欢阅读|I really like to read.
这艘船的长度是30米|The length of this ship is 30 meters.
道路法规必须被严格遵守|The rule of the road must be strictly observed.
这是你要找的书|This is the book you are looking for.
你要告诉我你到底想让我干嘛|You need to tell me what you want me to do.
汤姆看起来很疑惑|Tom looked puzzled.
马蒂亚斯来自乌拉圭他是乌拉圭人|Matías is from Uruguay. He is Uruguayan.
他到了火车站就叫了辆出租车|On his arrival at the station, he called a taxi.
诚信是一种重要的美德|Honesty is a capital virtue.
我不喜歡電影|I don't like movies.
给我看下它吧|Show it to me.
这很好|This is very good.
湯姆可以比我做得好很多|Tom can do so much better than I can.
我爸爸們住在澳洲|My fathers live in Australia.
他是美国人|She's American.
好吧你赢了|OK, you win.
明白事理的人使自己适应世界不明事理的人想使世界适应自己所以所有进步都要靠不明事理的人|Those who understand adapt to the world; those who don't understand want the world to adapt to them. This is why all human progress depends on people who don't understand.
现在才6点半怎么会堵车呢|How can there be a traffic jam now, as late as 6 o'clock?
商人們只看中利益|Merchants only look at the profits.
汤姆会说三门语言|Tom can speak three languages.
看來她會改變主意|It appears that she might change her mind.
風很大, 所以我走不快|The wind is strong, so I am not going quickly.
雖然考試近了, 他還沒有把書唸完|He could not get through his work, though the examination was near.
他去过很多地方|He has been to many places.
我数学学的很好|I am good at math.
我們去打棒球吧|Let's play baseball!
你们去哪儿?|Where are you going to?
那裡太多人了|There are too many people there.
可以这样写吗|Can I write it like that?
她總是信守承諾|She always keeps her promises.
湯姆說你從來沒去過澳大利亞|Tom says that you've never been to Australia.
它没有吃|It didn't eat.
这个理论很有争议|This theory is very controversial.
我不喜歡在泳池裏游泳|I don't like swimming in pools.
看完这封信请把它烧掉|When you have finished reading this letter, burn it.
這座建築物快完工了|This building is near completion.
他完全出自善心|He did it all out of kindness.
日本比加拿大小|Japan is smaller than Canada.
那張桌子對梅格來說太小了|That desk is too small for Meg.
我的鉛筆掉了|I have lost my pencil.
你在东京如何维持生计|How did you make a living in Tokyo?
他到了火車站的時候火車已經開出了差不多半小時|When he reached the station, the train had already left almost half an hour before.
這次不一樣|This time, it's different.
汤姆经常不守约|Tom often doesn't keep his promises.
正在下雨孩子们没有在院子里玩儿|It's raining, so the kids aren't playing in the yard.
我八點會跟你見面|I'll meet to you at eight.
我的手机在响|My cellphone is ringing.
就算我富有我也不会给他钱|Even if I were rich, I wouldn't give him money.
我很讨厌有女的说“男人都一样”|I hate it when women say that all men are the same.
今天我有四节课|I have four lessons today.
艾马提我们需要更多肉|Emet, we need more meat!
瞄準麻雀, 擊中鵝|I aimed at a sparrow, but shot down a goose.
我是你的夥伴|I'm your partner.
因为有高而闭合的领子紧身的剪裁和在笔直裙子两边的开口旗袍有着独一无二传达端庄和性感的能力|With a high, closed collar, figure-hugging cut, and large slits at either side of a straight skirt, the qipao is unique in its ability to communicate both modesty and sensuousness.
太陽系是銀河系中一個小的天體系统|The solar system is a small celestial system in the Milky Way.
胡說|Bullshit.
瑪麗說你偷了她的車|Mary said you stole her car.
她决定搬到比利时|She decided to move to Belgium.
這附近有公交站嗎|Is there a bus stop nearby?
不要哭得像个孩子似的|Don't cry like a child!
汤姆教了我法语|Tom taught me French.
公車票價多少錢|How much is the bus fare?
許多家庭主婦抱怨物價非常高|A lot of housewives complain about the high prices of goods.
现在是七点四十五分|It's quarter to eight now.
他喝了一杯純威士忌酒|He took a drink of whiskey neat.
她一直都相信我|She always believes me.
我完全不明白他為甚麼會突然辭職|I haven't got a clue as to why he quit so suddenly.
Facebook在中國是被封鎖的|Facebook is blocked in China.
不要说日语|Don't speak in Japanese.
電線被用來運送電力|Wires are used to convey electricity.
时装不是我的天分|Fashion isn't my specialty.
我对这个单词不熟|The word is unfamiliar to me.
湯姆說瑪麗害羞|Tom said Mary is shy.
安的弱點就是巧克力|Ann has a weakness for chocolate.
那是一个笔误|It's a slip of the pen.
感谢你过来帮我|Thank you for coming to help me.
他像国王一样开心|He's as happy as a king.
我在等你们你们什么时候准备好|I'm waiting for you. When are you ready?
他吃|He ate.
你知不知道全世界每年有多少人饿死呀|Do you know how many people in the world starve to death every year?
你為什麼拒绝了他的提議|Why did you turn down his offer?
我一沒錢二沒時間|For one thing, I've no money, and for another, I've no leisure.
她25岁就结婚了|Because she is twenty-five years old, she gets married.
讓我們開車到湖邊|Let's drive to the lake.
我能把这个东西带到飞机上吗|Can I carry this on the plane?
你的智慧廣大的有如孟買和孟買之間的距離|Your intelligence is as vast as the distance between Bombay and Mumbai.
玛丽处理了膝盖的伤口|Mary treated her wounded knee.
只有你来了她才会来我的生日派对|Only if you come will she come to my birthday party.
他們完全損壞了國家的形象|They completely destroyed the image of the country.
那天我不行|That's a bad day for me.
Ania 对计算机很感兴趣|Ania is interested in computers.
没人能够预言这次合作的结果|No one could predict the outcome of this cooperation.
让汤姆帮你|Ask Tom to help you.
昨天相当的冷啊|It was terribly cold yesterday.
猎人在田野追兔子|The hunter chases the rabbit in the fields.
我看一下你的词典行吗?|Can I look at your dictionary?
“你怎么来了”他惊讶地问我|"What are you doing here?" he asked me in surprise.
你读这本书应该很容易|You should be able to read this book easily.
给我老公打电话|Call my husband.
她說他不會戒煙|She says he will not give up smoking.
你知道我幾歲嗎|Can you tell my age?
終於明白啦|Do you finally understand?
我看见天上有奇怪的东西|I saw something strange in the sky.
如果你有什麼不懂的就問啊|If there is something you don't understand, then ask.
入场费只需五元|Admission to the show is $5.
她的女兒已經變成一個漂亮的女人|Her daughter became a beautiful woman.
我不知道如果沒了你我還能做什麼|I don't know what I would do without you.
湯姆昨天缺席了|Tom was absent yesterday.
大衛吃了很多東西|David ate a lot of things.
要这么做你需要冒险|In order to do that, you have to take risks.
我們在一家植物園裏找到了許多稀奇古怪的植物|We found many strange plants in a botanical garden.
不要打开你的书|Do not open your book.
桌上有一只橙子|There is an orange on the table.
我该去睡觉了|I have to go to bed.
我們點了太多的食物|We ordered too much food.
比爾有很多朋友|Bill has many friends.
春天我想要彻底打扫房子|I want to do spring cleaning.
我想要成為詩人|I would like to become a poet.
金龜子是昆蟲|Scarabs are insects.
我是吗犹太人?|Am I Jewish?
湯姆老得不能工作了|Tom is too old to work.
你幾點鐘去學校|What time do you leave for school?
我的手机充电器坏了|My phone charger is broken.
没有科学就没有未来|Without science, there is no future.
她又漂亮又聰明而最棒的是她還是一個十分善良的人|She is beautiful, intelligent and, what is best of all, very kind-hearted.
馬停了下來而且拒絕移動|The horse stopped and wouldn't move.
肯尼迪总统被刺杀了但是他的传奇会永久长存|President Kennedy was killed, but his legend will live on forever.
这是个挺好的故事|It was a nice story.
我害怕一個人去|I'm afraid to go alone.
我不相信汤姆的说法|I don't believe Tom's version of the story.
汤姆总是多管闲事|Tom always meddles in affairs that do not concern him.
我從出租車上下來|I got out of the taxi.
我对那天的印象很深刻|That day left a deep impression on me.
從前文後理來推斷一個字的意思|Get the meaning of a word from its context.
今天是星期四|It is Thursday.
我們去南法散心|We go to the South of France for a change of air.
他昨天过世了|He deceased yesterday.
他跟我不住在一个小区|He doesn't live in my neighborhood.
你昨天沒來學校, 是嗎?|You didn't come to school yesterday, did you?
我用现金付款|I pay in cash.
她年轻的时候非常漂亮|She was very beautiful in her youth.
我会教你怎么开车|I can teach you how to drive.
他想要成功即使是以他的健康作为代价|He wanted to succeed, even at the cost of his health.
我们可以帮汤姆|We can help Tom.
我喝果汁|I drink fruit juice.
人们说爱情是盲目的|They say that love is blind.
这些措施可以预防疾病蔓延|These measures can prevent the disease from spreading.
你為甚麼不抱我|Why don't you hug me?
我來這個國家的目的是學習音樂|I came to this country for the purpose of studying music.
我们不常做|We don't do it very often.
我听到电话响了|I heard the telephone ringing.
我对摄影感兴趣|I have an interest in photography.
經濟情況惡化|The economic situation grew worse.
我需要一本日英字典|I need a Japanese-English dictionary.
阿尔法贝塔和咖玛是希腊文字|Alpha, beta and gamma are Greek letters.
鬼魂是存在的|Ghosts exist.
因为曾遇见过那个女孩我马上就认出来了|Having met the girl before, I recognized her at once.
我們馬上成為了朋友|We immediately became friends.
我以为你在听|I thought that you were listening.
他否認打破了窗口|He denies having broken the window.
他不像他的兄长那样聪明|He is not as intelligent as his older brother.
我想唱個歌|I want to sing a song.
這些水聞起來很香|This water smells good.
雅妮像中了圈套的狼一样惊慌|Yanni panicked like a wolf in a snare.
汤姆应该去澳洲但他没有|Tom should've visited Australia, but he didn't.
再見|Bye!
我试试思想|I try to think.
我很抱歉今天您来的时候没能见您|I'm sorry I wasn't able to see you when you came by today.
你應該立即開始|You should begin right away.
我的名字不是這樣寫的|That's not how my name is spelled.
我今天要早点回家|I need to go home a little early today.
然而相反的理论往往也是真的|And yet, the contrary is always true as well.
那是好久以前|That was a long time ago.
汤姆和肯长得一模一样|Tom and Ken are like peas in a pod.
十二十三十四十五十六十七十八十九十一百|Ten, twenty, thirty, forty, fifty, sixty, seventy, eighty, ninety, hundred.
我喜歡讀這本小說|I've enjoyed reading this novel.
他们想和你互相谈谈共同的兴趣领域|They want to talk to you about areas of mutual interest.
我听到这个很开心|I'm glad to hear that.
每一個孩子都應該享有平等的學習機會|It is essential that every child have the same educational opportunities.
英式英語和美式英語在很多地方上有所不同|British English differs from American English in many ways.
她把她的傘留在公車上了|She left her umbrella on the bus.
我是一只猫|I am a cat.
十支隊伍競逐獎項|Ten teams competed for the prize.
詹妮弗在小村过平静的日子不像我们在城市忙碌的生活|Jennifer lives a peaceful life in the small village, unlike us with our busy city lives.
把書放在你找到的地方|Put the book where you found it.
現在太暗無法打棒球|It's too dark to play baseball now.
你的錶慢了10分鐘|Your watch is ten minutes slow.
我快把我的午饭忘了|I almost forgot my lunch.
我既紧张又害怕|I am nervous and scared.
他在厨房|He is in the kitchen.
教授微微笑了一下|The professor smiled a little.
你買了什麼|What did you buy?
證據對他有利|The evidence was in his favor.
他的三個孩子都成為了音樂家|His three children all became musicians.
走啊大家可以开始走了|Go! Everybody can start to go!
跟她說我正在看新聞|Tell her that I am watching the news.
誰也說不準實際上將會發生什麼事|What will actually happen is anyone's guess.
告訴湯姆他應該坐哪兒|Tell Tom where to sit.
瞧你身後|Look behind you.
我昨晚学习了|I studied last night.
你們家燈没亮所以我以爲你們不在家|Your lights weren't on, so I thought you weren't home.
他們已經結婚十年了|They have been married for ten years.
阿姨您别客气喝杯开水就行|No need to trouble yourself, Auntie. A glass of boiled water will be plenty.
你可以坐你想坐的任何地方|You can sit wherever you want to.
山坡上有一间村屋|There was a cottage on the side of the hill.
这场爆炸中有三人丧生|Three people were killed in the explosion.
我觉得她不该这么做|I don't think she should've done that.
用筷子吃飯難嗎|Is eating with chopsticks difficult?
爸爸买了一个照相机|Dad bought a camera.
坐火車去比較便宜|In comparison, taking the train is cheaper.
那位先生靠什么生活|What does that gentleman do for a living?
你在掩饰什么|What are you hiding?
请把打印机里面的空的墨粉鼓换掉|Please replace the empty ink cartridge in the printer.
滚出我家|Get out of my house!
我興奮得睡不著覺|I was so excited that I could not fall asleep.
湯姆跟瑪莉跟我說他們會去做那件事|Tom and Mary told me they were going to do that.
我還要享受更多|I want to enjoy much more.
我決定今年不休假|I decided not to go on holiday this year.
亞歷山大大帝死在巴比倫|Alexander the Great died in Babylon.
她的裙子是用粗糙的羊毛造的|Her dress was made of coarse wool.
你今晚看電視了嗎|Have you watched television tonight?
瑪麗喜歡植物|Mary likes plants.
没事的别害怕|It's nothing, don't be afraid!
因為他不小心所以才會發生意外|The accident was brought about by his carelessness.
这些苹果你们三个人分|Divide these apples between you three.
他比我高|He's taller than I am.
她给孩子们做了曲奇|She made cookies for the children.
你这么说很失礼|It is rude of you to say so.
中国乒乓球队进行了一个月的封闭式冬训|The China National Table Tennis Team had a month's closed training in winter.
我怀疑如果玛丽处在你的位置上是否还会那样做|I doubt if Mary would do that if she were in your shoes.
总有一些人不讲理|There are always some people who are unreasonable.
您差不多猜对了|Your guess is almost right.
斯德哥爾摩是瑞典的首都|Stockholm is the capital of Sweden.
晚上可能会下雨|It may rain tonight.
今天來了很多人|A lot of people came today.
他们每周尝一次肉|They eat meat once a week.
纸是中国发明的|Paper was invented in China.
汤姆是怎么说服玛丽照顾他的小孩的呢|How did Tom talk Mary into babysitting his children?
他们奋斗的目标是消灭天花|They are struggling with the goal of wiping out smallpox.
这个产品称它能帮助你减肥|This product claims to help you lose weight.
我们看了窗外但什么都没看见|We looked out the window, but we didn't see anything.
我买了这双鞋但是有点太小了|I bought this pair of shoes, but they are a bit too small.
你認爲湯姆退休了嗎|Do you think Tom is already retired?
汤姆想追随他父亲的脚步|Tom wanted to follow in his father's footsteps.
他只會說英語和德語這兩種語言我都不懂|He speaks only English and German, neither of which I understand.
他死了我真难受|I am very sad that he has died.
玛丽宣布和汤姆订婚|Mary announced her engagement to Tom.
虽受邀参加今晚一个精彩万分的派对奈何明日不得不打起精神出席会议只好推辞了|I got an invitation to a party tonight that I know would be a lot of fun but I have to be in my best form for tomorrow's meeting so I had to turn it down.
藤村和白秋这样的诗人太少了|Such poets as Toson and Hakushu are rare.
他為一家廣告公司工作|He works for an advertising agency.
人們可以很容易地看出其中的差別|People can easily tell the difference between them.
我家只有三口人|There are only three people in my family.
你怕啥就是部電影罷了|Why are you so scared? It's just a movie.
你记得了你父亲的生日吗|Did you remember your father's birthday?
放開我的手臂我不能忍受有人碰我|Let go of my arm! I can't stand people touching me.
你现在是大人了|You are now an adult.
我好想快點再去英國|I am anxious to visit Britain once again.
那挺逗的|That was pretty funny.
我丢了我的帽子|I have lost my cap.
做个讨人喜欢的小朋友|Be a good girl.
我没通过|I didn't pass.
就算是全世界跑得最快的人也要吃飽了才跑得動|Even the fastest runner in the world cannot run if he is hungry.
若同期的人先一步完成銷售目標我也不能再吊兒郎當了|When one of my coworkers starts racking up good sales figures I can't let down my guard.
我們今天不是要去公園嗎|Aren't we going out to the park today?
不要让孩子们在街上玩耍|Don't let the children play on the street.
凱特養了一隻狗|Kate keeps a dog.
湯姆在家因為他病了|Tom stayed at home because he's sick.
可以給我一點吃的嗎我快餓瘋了啦|Please give me something to eat. I am so hungry.
在村莊裏我們還是用木頭給房子取暖|In the village we still heat our homes with wood.
他在森林中迷了路|He lost his way in the woods.
其实书面语我搞得相当好但是口语中我经常会记不起来某个字的音调|I'm actually relatively good at written language, but with spoken language I often can't remember the tone on some word.
在多年的思索之下我終於了解人生的意義就是去尋找人生的意義我們每個人都是獨特的個體我們每個人都能找到屬於自己的人生目標|After many years of thinking, I came to a conclusion that everyone's meaning of life is actually to find the meaning of life. Every one of us is a unique individual. And every one of us has his own capability to find in his life one particular mission to fulfill.
我從來沒去過廣島|I have never been to Hiroshima.
你甚沒問過我怎麼想|You haven't even asked me what I think.
你踢足球嗎?|Do you play soccer?
我不懂你的心|I don't know your heart.
昨天我帮了他|I helped him yesterday.
下個月我在英國|Next month, I am going to England.
喬治很傷心|George was broken-hearted.
湯姆答應再試一次|Tom promised to try again.
您新買的是輛嶄新的車嗎|Have you bought a brand-new car?
您有空嗎|Are you available?
你知道我住哪吗|Do you know where I live?
我寧可死也不屈服|I would rather die than yield.
我能叫你Bob吗|Can I call you Bob?
他試圖跟我們說法語|He tried speaking French to us.
初次穿着前要先清洗|Wash before first wearing.
湯姆不知道他還能再信任誰|Tom doesn't know who he can trust anymore.
英語不是一朝一夕就能學會的|English cannot be mastered overnight.
你昨天上午在打网球吗|Did you play tennis yesterday morning?
汤姆买了新笔记本|Tom bought a new notebook.
一领到工资就把钱还给你|I'll pay you back once I receive my salary.
这是我的电子邮箱|Here is my email address.
我应该多加注意|I should have paid closer attention.
汤姆决定留在澳洲|Tom decided to stay in Australia.
如果你不想那你便没有这个必要去告诉汤姆|You don't have to tell Tom if you don't want to.
别麻烦保安了|Don't bother calling security.
这对谁有好处|Who benefits from it?
怎么你昨晚没有给我打电话|Why didn't you call me last night?
她一定为你感到骄傲|She must be proud of you.
这把椅子很轻|This chair is light.
汤姆胜利了|Tom won.
前天發生了火災|A fire broke out the day before yesterday.
汤姆跑得很快|Tom can run fast.
我不需要你的同情|I don't need your sympathy.
你應該認為這是個很可觀的改進|You must think of this as a great improvement.
考试时间为两个半小时|The exam was two and a half hours long.
一艘船突然从雾中出现|A boat suddenly appeared out of the mist.
房間裡沒有人|There was no one in the room.
你想怎么做|How do you want to do it?
其实没有发生|That didn't really happen.
請記得把信寄出去|Please remember to mail the letter.
必须有外交解决的途径|There must be a way to arrive at a diplomatic solution.
几只苹果|How many apples are there?
我會說一點日文|I speak a little Japanese.
选举一致通过了|The election was unanimous.
汤姆闭上了眼睛|Tom shut his eyes.
他賣車子|He sells cars.
汤姆准备好了吗|Is Tom ready for that?
当且仅当你知道我们的密码你才可以进来|You can come in if and only if you know our password.
把電視關了|Turn the TV off.
她是在一個小時前出發的所以現在應該已經到了|She should be there now because she left an hour ago.
不管你有什么冠冕堂皇的理由这样做是不对的|No matter what grand and lofty reason you have, it's not right to do this.
Tom今天没来上班|Tom didn't show up for work today.
学生们表演哈姆雷特|The pupils performed Hamlet.
燕妮要发脾气了|Yanni was losing his temper.
我平常早上八点钟起床|I usually get up at 8.
你為什麼這麼神秘|Why are you being so secretive?
这里每一个人都害怕你|Everyone here is afraid of you.
汤姆穿着袜子睡觉|Tom sleeps with his socks on.
我在百貨公司買了它|I bought it at a department store.
我们不相信汤姆|We don't trust Tom.
亞當為什麼吃了禁果呢|Why did Adam eat the forbidden fruit?
把你的書和筆記本收起來|Put away your books and notebooks.
您上學可能會遲到|You may be late for school.
我還沒有準備好|I'm not ready yet.
汤姆在澳大利亚呆了三年|Tom stayed in Australia for three years.
这是谁的坟墓|Whose tomb is this?
她不喜欢足球|She doesn't like soccer.
你在暗示什么|What are you driving at?
湯姆對數學感興趣|Tom is interested in mathematics.
她在晚飯前把自己梳洗打扮了一下|She freshened herself up before supper.
我能看看电话簿吗|May I see the telephone directory?
很明顯的是這兩者之間有很強烈的分歧|It's clear that there's a rather strong disagreement between the two.
没人理解我|No one understands me.
手续费是多少|How much is the commission?
我的寵物生病了|My pet is sick.
汤姆跑得快|Tom runs fast.
那些人裡面有5個俄羅斯人|There are five Russians among the party.
书桌上有一个包|There is a bag on the desk.
差點就對了|That is almost correct.
她經常上學遲到|She was often late for school.
演员的皮肤是化过妆的|The actress' skin has makeup on it.
我是在北京学习中文的|It was in Beijing that I studied Chinese.
我繼續工作|I continued working.
我爸媽要離婚了|My parents are getting divorced.
你到底怎麼回事啊|What's happened to you?
他们之间隔着很远的距离|They are separated by a great distance.
这个俱乐部里有50个会员|There are fifty members in this club.
墨西哥有很多贫民窟|There are many shantytowns in Mexico.
自由职业的优点是人们可以自由的分配他们的工作时间它的缺点是人们实际上必须24小时不间断的工作|The advantage of freelancing is that you can divide your time freely. The disadvantage is that you actually have to work around the clock.
汤姆说他愿意帮忙|Tom says that he's willing to help.
不我还是喜欢吃蔬菜|No, I still prefer eating vegetables.
读书很重要|Reading books is important.
他吃了一盒巧克力|He ate a box of chocolates.
這裏附近有沒有郵政局|Is there a post office around here?
成为医生的路还很长|I'm still miles off becoming a doctor.
一連下了十天雪|It snowed for ten consecutive days.
您知道這附近有便宜的旅館嗎|Do you know of a cheap hotel in the area?
你現在最好回家|You'd better go back home now.
我的眼睛疲劳|My eyes are both tired.
假如你没有这个程序你现在就可以去下载|If you don't have this software, you can download it now.
我上次计算估计我已经学会了两千五百个汉字左右|Last time I counted, I estimated that I know around 2500 Chinese characters.
周日我去做礼拜|On Sunday, I go to church.
汤姆欠我们个情|Tom owes us a favor.
银行什么时候关门|When does the bank close?
謠言是毫無根據的|The rumor was without foundation.
我可以坐在你旁邊嗎|May I sit next to you?
這家商店有各種香料|This store has a variety of spices.
你看到的這些花是玫瑰|These flowers you see are roses.
我一直想试一试|I have always wanted to try it.
外面打雷了我很害怕|It's thundering outside. I'm really scared!
这个男孩很有前途|The boy is full of promise.
他们是热爱和平的人|They are a peace-loving people.
趁汤没凉你把汤喝了|Drink the soup while it is hot.
我们测量了这条河的深度|We measured the depth of the river.
湯姆熱愛滑雪|Tom loves to ski.
我都不知道该怎么夸他们了|I cannot praise them too highly.
我觉得你在撒谎|I think you're lying.
圈养导致大猩猩生病|Captivity makes gorillas sick.
無論通過行納粹禮還是將手放在胸前我認為這種愛國主義的表現是一種病的症狀而病因和治療方法有待進一步研究|Whether by a Hitler salute or a hand on your heart, I consider the expression of patriotism to be the symptoms of a disease, whose cause and cure should be more closely studied.
对严格限制经济的批评蜂拥而来|Critics are coming down hard on tightened economic restrictions.
汤姆很不好意思去求帮忙|Tom was embarrassed to have to ask for help.
昨天他研讀英語了嗎|Did he study English yesterday?
六七月份雨很多|It rains a lot during June and July.
你的作业做完了没有|Have you finished your homework?
我马上就认出了他|I recognized him right away.
人生中有許多不可解的事物|There are many mysteries in life.
我等了我朋友半個小時但是他還是沒出現|I waited half an hour for my friend, but he didn't turn up.
把书给我|Give me that book.
我今天去理发|I'm going to the barber today.
今天是几号|What's the date today?
我記得在巴黎見過他|I remember meeting him in Paris.
你不能進這個房間|You are not allowed in this room.
今天是星期日|Today is Sunday.
是珍妮贏得了第一名|It was Janet that won first prize.
你的车很快但是我的更快|Your car is fast, but mine is faster.
我完全赞成你的观点|I fully agree with your point of view.
什么是幸福|What is happiness?
沒有必要回那封信|You don't need to answer that letter.
孩子们早上去学校|The children go to school in the morning.
哈拉和林是蒙古的前首都|Karakorum is the early capital city of Mongolia.
他們昨天平安抵達這裡|They arrived here safely yesterday.
我為你的殿心裡焦急如同火燒|Zeal for your house will consume me.
你学习荷兰语有多久了|How long have you been learning Dutch?
它太大聲|It's too loud.
本把他的雙手伸到了他的褲兜裡|Ben put his hands in his pockets.
她回来了|She's returned.
你不要随意评判别人的传统文化|Don't judge other people's traditional culture.
我想家|I'm homesick.
铁路与公路平行|The railroad is parallel to the road.
Tom看上去对英语测试的结果很担心|Tom looked worried about the result of an English test.
我无法遏制住我的怒火|I couldn't control my anger.
永远|Always.
我最近很寂寞|I feel very lonely these days.
你是學生|You're a student.
他們終於達到了目的|They attained their purpose at last.
保镖戴着耳机|The bodyguard was wearing an earpiece.
明天九点打电话给我吧|Call me at 9:00 tomorrow.
汤姆本可以用更好的方式处理问题|Tom could have dealt with the problem in a better way.
酒店中有花店吗|Is there a flower shop in the hotel?
他们出发去野餐了|They set out on a picnic.
我們被鼓勵使用想像力|We are encouraged to use our imagination.
你最喜欢的城市是什么|What's your favorite city?
水對人是很重要的|Water is important for people.
他很討厭蛇|He has an abhorrence of snakes.
我正在吃东西|I am eating.
你是我的朋友|You are my friend.
你要是不收拾好你的房間的話哪兒都別想去|You're not going anywhere until your room is clean.
你不應該做的|You shouldn't have done it.
我在修理回家路上捡到的收音机|I'm fixing the radio which I found on my way home.
汤姆不是纯素食者|Tom's not a vegan.
真是烦死了|It really is very annoying.
雨后气温下降了|There was a drop in temperature after the rain.
您迷路了吗|Are you lost?
你喜歡電影嗎|Do you like movies?
我们觉得他的威胁只是一个玩笑|We thought his threat was only a joke.
把你的腿抬起來|Raise your leg.
圣诞节快乐|Merry Christmas!
梅格同意肯的計劃|Meg agreed to Ken's plan.
以防下雨你最好带把伞|You'd better take an umbrella with you in case it rains.
我虽然在虎口里却是安如泰山|Though I am in the tiger's mouth, I am as calm as Mount Tai.
如果持續疼痛, 你必須去看醫生|If the pain continues you have to go to the doctor.
大炸彈從天而降奪走了許多人的生命|A big bomb fell, and a great many people lost their lives.
我的朋友叫我肯|My friends call me Ken.
给我点事做|Give me something to do.
我等了接近半小时|I waited just under half an hour.
我为Ann做了个娃娃|I made a doll for Ann.
飞机十分钟后起飞|The plane takes off in ten minutes.
我们不年轻|We are not young.
他全世界都有朋友|He had friends all over the world.
这些高官和富商的大四合院常常有精美雕刻并粉刷的横梁和柱子并伴有精心修剪的花园|The large siheyuans of these high-ranking officials and wealthy merchants often featured beautifully carved and painted roof beams and pillars and carefully landscaped gardens.
他们在相册里面加了些图片|They add pictures to their album.
珍帶她的狗去散步了|Jane took her dog for a walk.
雖然正在刮暴風雨但他還是出去了|In spite of the storm, he went out.
我好想念你|I miss you.
快步前进同志们|Hurry on, comrades!
胡扯!|That's bullshit!
瘋了!|Wild!
你喜歡嗎|Do you like it?
你相信有鬼魂吗|Do you believe in the existence of ghosts?
我想吃點好吃的|I want to eat something delicious.
你是我的英雄|You're my heroine.
我已經做了我的家庭作業|I've already done my homework.
可憐可憐我吧|Have pity on me!
這個袋子裡的柳橙都爛了|The oranges in this bag are rotten.
風愈吹愈猛|The wind is picking up.
她給我看她的相簿|She showed her album to me.
她只是一个平凡的小女孩|She is just an ordinary girl.
我知道但我沒說對|I know it, but I can't hit on it.
我听说你在试图帮助汤姆的时候受伤了|I heard you were injured trying to help Tom.
他怕坐飞机|He's afraid of flying.
有人可以接電話嗎?|Can someone answer the telephone?
嗨我可能没钱但我一直有我的骄傲|Hey, I may have no money, but I still have my pride.
盒子裡有任何東西嗎?|Is there anything in the box?
我在兵库县立大学学习|I'm studying at the University of Hyogo.
她為她的成功感到高興|She is pleased at her success.
汤姆非常性感|Tom is so hot.
您太好了|You're the best.
他为什么在躲藏|Why is he hiding?
他星期日並不總是在家|He's not always at home on Sundays.
我的父亲65岁的时候退休了|My father retired at 65 years old.
她叫他坐下|She asked him to sit down.
想吃什么就吃什么吧|Help yourself to anything you'd like to eat.
许多灯照亮了街道|The street is illuminated by many lights.
这不是件困难的差事|This isn't a difficult job.
我還有一個問題|I have another question.
她疼得哭了|She gave a cry of pain.
见到她我很高兴|I was happy to see her.
你吃過午飯了嗎|Have you had lunch?
那些花兒安慰了她|The flowers cheered her up.
她想方设法以一己之力完成了工作|She managed to finish the work on her own.
上個月我換了我的地址|I changed my address last month.
她已经五天不上学了|She has been absent from school for five days.
倫敦是英國的首都|London is the capital of England.
我不在就别开始|Don't begin without me.
我想让他单独去做|I want him to do it alone.
我注意到她当时戴了顶新帽子|I noticed she was wearing a new hat.
蘇珊擦亮了她父親的鞋|Susan polished her father's shoes.
这种啤酒有苦味|This beer tastes bitter.
你甚麼也沒寫|You didn't write anything.
你知道吗我从没见过你跟一个男人一起|You know, I've never seen you with a guy before.
我肚子饿极了|I'm super hungry.
你最喜欢哪一个绕口令|What's your favorite tongue twister?
只有四匹马参加了比赛|Only four horses participated in the competition.
他剛請假走了|He's just gone on leave.
我知道他在注意我|I know he is watching me.
汤姆在街的那边向她打招呼|Tom called to her across the street.
绳子在哪里|Where's the rope?
除非有人跟他說話他從來不說話|He never speaks unless spoken to.
我常常覺得悲傷|I often feel sad.
希望她早日康復|I hope that she will get well soon.
我非常喜欢我的工作|I love my work very much.
我已經知道答案了|I already know what the answer is.
我习惯于收集琐碎的物件像是集市上卖的香膏小蜡烛与烛台只要是那种小巧又可爱的东西我都会很喜欢|I tend to collect tiny little objects, like balms sold on the market, little candles and candlesticks. As long as they are tiny and cutesy, I like them.
假如你有1000美元你会用它做什么呢|Suppose you had a thousand dollars, what would you do with it?
把箱子放下|Put the box down.
我承认我不太喜欢汤姆|I admit that I don't like Tom very much.
哄堂大笑|The whole audience erupted in laughter.
你可以给我一张床单吗|Can you give me a sheet?
印度是世界第七大的國家|India is the seventh largest country in the world.
看厨房里有一只猫|Look, there's a cat in the kitchen.
